,1_star_ratings,2_star_ratings,3_star_ratings,4_star_ratings,5_star_ratings,total_ratings,avg_ratings
god of war iii - playstation 3,10,8,26,58,327,429,4.594405594405594
diablo iii,112,62,58,52,118,402,3.0049751243781095
infamous - playstation 3,4,10,36,93,214,357,4.408963585434174
resident evil 5 - playstation 3,10,15,50,110,169,354,4.166666666666667
assassin's creed - playstation 3,11,19,48,63,159,300,4.133333333333334
the last of us remastered - playstation 4,9,7,12,15,254,297,4.6767676767676765
dead space (playstation 3),0,2,18,66,207,293,4.631399317406143
assassin's creed,17,25,44,80,119,285,3.9087719298245616
uncharted 4: a thief's end - playstation 4,10,2,16,35,215,278,4.593525179856115
mario kart wii with wii wheel,6,2,14,57,198,277,4.584837545126354
killzone: shadow fall (playstation 4),15,28,46,61,110,260,3.8576923076923078
wii,4,13,23,43,174,257,4.439688715953308
bloodborne,19,12,21,36,164,252,4.246031746031746
destiny - standard edition - playstation 4,39,30,46,38,90,243,3.4526748971193415
dead space (x-box 360) platinum hits,4,2,18,52,165,241,4.54356846473029
uncharted: drake's fortune - playstation 3,7,6,19,46,156,234,4.444444444444445
assassin's creed unity limited edition - playstation 4,29,25,29,45,103,231,3.727272727272727
mario kart 8 - nintendo wii u,4,4,8,35,178,229,4.655021834061135
metal gear solid 4: guns of the patriots,6,6,10,27,178,227,4.607929515418502
starcraft ii: wings of liberty,44,30,20,56,77,227,3.405286343612335
resident evil 5 - xbox 360,16,16,26,46,117,221,4.049773755656108
final fantasy xiii - playstation 3,23,27,36,39,96,221,3.7149321266968327
gears of war 2 - xbox 360,4,6,20,41,150,221,4.479638009049774
resistance 2 - playstation 3,6,12,34,48,120,220,4.2
playstation 3 dualshock 3 wireless controller (black),4,6,18,26,160,214,4.5514018691588785
halo 4 - xbox 360 (standard game),8,10,14,39,139,210,4.385714285714286
mortal kombat vs. dc universe - playstation 3,6,10,26,40,126,208,4.298076923076923
batman: arkham knight - playstation 4 [digital code],12,5,25,41,122,205,4.248780487804878
watch dogs - playstation 4,13,14,29,43,103,202,4.034653465346534
yoshi amiibo (super smash bros series),2,3,2,11,183,201,4.840796019900497
alan wake - xbox 360,8,10,36,58,88,200,4.04
uncharted 2: among thieves - playstation 3,3,2,10,17,166,198,4.722222222222222
final fantasy x,11,11,16,42,118,198,4.237373737373737
titanfall - xbox one,24,13,22,35,103,197,3.9137055837563453
far cry 4 - playstation 4,7,11,17,33,128,196,4.346938775510204
borderlands - xbox 360,4,4,20,52,113,193,4.3782383419689115
halo - xbox,7,0,8,33,145,193,4.601036269430052
until dawn - playstation 4,10,5,12,26,140,193,4.455958549222798
call of duty: modern warfare 3 - xbox 360,14,22,29,42,80,187,3.8128342245989306
gears of war 3,0,3,14,40,128,185,4.583783783783784
the witcher 3: wild hunt - playstation 4,11,6,13,27,128,185,4.378378378378378
wii fit game with balance board,2,4,2,50,126,184,4.5978260869565215
fallout 4 - playstation 4,10,10,11,37,116,184,4.298913043478261
xbox 360 wireless controller - glossy black,3,2,7,21,147,180,4.705555555555556
middle earth: shadow of mordor - playstation 4,9,10,17,32,111,179,4.262569832402234
super mario 3d world - nintendo wii u,6,1,6,13,152,178,4.707865168539326
halo 3 - xbox 360,6,8,22,44,97,177,4.231638418079096
super smash bros. - nintendo wii u,8,3,13,14,139,177,4.5423728813559325
new super mario bros. wii,4,4,12,33,124,177,4.519774011299435
grand theft auto iv - playstation 3,9,5,17,46,97,174,4.247126436781609
halo: the master chief collection,27,13,16,23,95,174,3.839080459770115
assassin's creed iv black flag - playstation 4,3,8,5,34,124,174,4.540229885057471
tomb raider: definitive edition - playstation 4,3,6,8,23,133,173,4.601156069364162
xbox one wireless controller (without 3.5 millimeter headset jack),12,4,8,21,128,173,4.4393063583815024
super smash bros. brawl,4,2,13,22,132,173,4.595375722543353
grand theft auto vice city,3,4,5,33,128,173,4.61271676300578
bioshock 2 - xbox 360,6,4,28,36,98,172,4.255813953488372
playstation eye,2,8,12,24,126,172,4.534883720930233
xbox 360 live 1600 points,2,0,8,11,150,171,4.795321637426901
tomb raider,1,5,6,31,128,171,4.637426900584796
horizon zero dawn - playstation 4,5,4,6,16,137,168,4.642857142857143
resident evil 6 - playstation 3,16,13,20,29,89,167,3.970059880239521
infamous: second son standard edition (playstation 4),8,4,15,37,102,166,4.331325301204819
playstation 4 camera (old model),4,3,19,34,106,166,4.4156626506024095
halo reach,6,5,15,28,109,163,4.404907975460123
assassin's creed iv black flag - playstation 3,4,5,4,30,119,162,4.574074074074074
metal gear solid v: the phantom pain - playstation 4,11,6,13,32,99,161,4.254658385093168
super smash bros. - nintendo 3ds,3,1,5,26,125,160,4.68125
final fantasy vii,3,1,5,28,123,160,4.66875
grand theft auto iv,4,16,21,30,88,159,4.144654088050315
mass effect - xbox 360,2,6,20,25,106,159,4.427672955974843
call of duty: ghosts - playstation 4,19,14,23,30,72,158,3.7721518987341773
killzone 2 - playstation 3,3,7,24,38,85,157,4.24203821656051
gears of war - xbox 360,4,4,16,32,100,156,4.410256410256411
call of duty 4: modern warfare - game of the year edition,6,2,14,20,114,156,4.5
halo 2 - xbox,3,6,13,40,93,155,4.380645161290323
nintendo ds lite polar white,4,2,8,16,121,151,4.642384105960265
the order: 1886 - playstation 4,10,11,28,38,63,150,3.8866666666666667
new super mario bros,1,0,10,21,118,150,4.7
mario kart 7,2,1,3,26,118,150,4.713333333333333
star wars: battlefront - standard edition - playstation 4,42,20,30,18,39,149,2.946308724832215
mass effect - pc,30,16,13,26,63,148,3.5135135135135136
bioshock - xbox 360,7,2,6,22,109,146,4.534246575342466
call of duty: black ops iii - standard edition - playstation 4,22,12,25,26,61,146,3.6301369863013697
call of duty 4: modern warfare - game of the year edition,6,2,10,24,104,146,4.493150684931507
super mario galaxy,4,5,2,13,121,145,4.6689655172413795
kingdom hearts,7,3,3,29,102,144,4.5
grand theft auto iii,1,5,8,18,112,144,4.631944444444445
beyond: two souls,4,11,16,28,84,143,4.2377622377622375
xbox one play and charge kit,9,2,5,13,114,143,4.545454545454546
ninja gaiden ii,4,2,14,42,80,142,4.352112676056338
far cry 3,6,2,16,29,89,142,4.359154929577465
far cry 2 - pc,47,20,12,24,39,142,2.915492957746479
demon's souls,10,5,17,26,82,140,4.178571428571429
no man's sky - playstation 4,36,20,23,19,42,140,3.0785714285714287
nintendo wii u pro controller - black,4,2,9,13,111,139,4.618705035971223
red dead redemption - playstation 3,6,0,8,31,93,138,4.4855072463768115
nintendo wii remote plus - white,0,0,3,13,122,138,4.86231884057971
the legend of zelda: a link between worlds 3d,3,0,5,16,114,138,4.72463768115942
heavy rain - greatest hits,3,4,9,39,82,137,4.408759124087592
max payne 3 - playstation 3,6,11,13,30,77,137,4.175182481751825
uncharted: the nathan drake collection - playstation 4,8,1,4,15,109,137,4.576642335766423
final fantasy ix,3,1,10,22,100,136,4.580882352941177
street fighter iv - playstation 3,8,6,14,30,78,136,4.205882352941177
tom clancy's the division - playstation 4,11,10,20,34,61,136,3.911764705882353
red dead redemption,6,4,8,29,88,135,4.4
crisis core: final fantasy vii - sony psp,0,8,4,37,84,133,4.481203007518797
knack (playstation 4),5,5,24,46,53,133,4.030075187969925
god of war - playstation 2,2,1,6,27,93,129,4.612403100775194
assassin's creed iv black flag - xbox 360,2,1,5,28,93,129,4.62015503875969
playstation 4 500gb console [old model][discontinued],7,4,9,22,87,129,4.37984496124031
xbox one + kinect,19,7,14,25,64,129,3.8372093023255816
god of war: collection - playstation 3,0,1,9,12,107,129,4.744186046511628
assassin's creed: syndicate - standard edition - playstation 4,7,6,11,28,76,128,4.25
playstation 2 console slim ps2,8,0,4,10,106,128,4.609375
assassin's creed ii - greatest hits edition - playstation 3,1,6,8,28,85,128,4.484375
ratchet & clank - playstation 4,1,1,6,17,102,127,4.716535433070866
animal crossing: new leaf,4,1,11,18,93,127,4.535433070866142
the world ends with you,8,8,8,10,93,127,4.354330708661418
batman: arkham origins - playstation 3,4,3,20,33,66,126,4.222222222222222
super smash bros melee,1,0,0,18,107,126,4.825396825396825
final fantasy viii,1,6,17,22,80,126,4.380952380952381
the legend of zelda: the wind waker,7,1,9,18,90,125,4.464
halo: combat evolved anniversary,2,2,11,29,81,125,4.48
infamous: second son limited edition (playstation 4),4,5,10,25,81,125,4.392
donkey kong country returns,4,2,9,22,87,124,4.5
grand theft auto: san andreas - playstation 2,4,1,7,19,93,124,4.580645161290323
the evil within - playstation 4,11,10,13,25,65,124,3.9919354838709675
sony playstation 3 160gb system,7,2,3,21,91,124,4.508064516129032
dualshock 4 wireless controller for playstation 4 - jet black [old model],5,1,4,7,106,123,4.691056910569106
powera dualshock 4 charging station for playstation 4,3,3,2,24,91,123,4.6016260162601625
grand theft auto v - playstation 4,4,1,7,15,95,122,4.60655737704918
dante's inferno divine edition - playstation 3,4,3,25,29,61,122,4.147540983606557
battlefield: bad company - playstation 3,2,2,16,34,68,122,4.344262295081967
uncharted: golden abyss - playstation vita,1,3,5,26,86,121,4.595041322314049
doom - playstation 4,6,2,13,13,86,120,4.425
resistance: fall of man - playstation 3,6,1,13,22,78,120,4.375
final fantasy xii,4,4,16,29,67,120,4.258333333333334
playstation 2 dualshock controller black,6,4,7,17,86,120,4.441666666666666
soul calibur iv - playstation 3,2,2,16,44,55,119,4.243697478991597
saints row 2 - xbox 360,2,0,10,34,73,119,4.4789915966386555
nintendo game boy advance sp - platinum,3,0,8,18,90,119,4.61344537815126
luigi's mansion: dark moon,2,1,4,19,93,119,4.680672268907563
call of duty: black ops ii - xbox 360,12,9,12,25,61,119,3.957983193277311
battlefield: bad company,3,4,8,38,65,118,4.338983050847458
"grip-it analog stick covers, set of 4",6,10,9,13,80,118,4.279661016949152
playstation 3 40gb system,2,0,2,20,94,118,4.728813559322034
playstation 2 console - black,11,3,6,23,74,117,4.247863247863248
fallout 4 - xbox one,8,3,11,16,79,117,4.3247863247863245
playstation 2 memory card (8mb),1,1,6,15,94,117,4.7094017094017095
pokemon x,3,2,6,10,95,116,4.655172413793103
super mario galaxy 2,3,1,4,9,99,116,4.724137931034483
playstation plus: 3 month membership [digital code],1,0,8,10,97,116,4.741379310344827
mortal kombat: komplete edition - playstation 3,0,3,3,17,92,115,4.721739130434782
metal gear solid v: ground zeroes - playstation 4 standard edition,12,2,11,22,67,114,4.140350877192983
super mario sunshine,1,3,18,37,54,113,4.238938053097345
mortal kombat vs. dc universe - xbox 360,6,4,14,18,70,112,4.267857142857143
32gb playstation vita memory card,15,4,13,19,61,112,3.955357142857143
perfect shot for wii (colors may vary),6,6,14,28,58,112,4.125
silent hill: homecoming - playstation 3,10,4,14,28,56,112,4.035714285714286
bioshock infinite - xbox 360,3,4,16,17,72,112,4.348214285714286
resident evil 7: biohazard - ps4 digital code,4,4,7,22,74,111,4.423423423423423
minecraft,3,2,2,10,94,111,4.711711711711712
diablo iii: ultimate evil edition,4,4,5,16,82,111,4.513513513513513
call of duty: world at war platinum hits - xbox 360,5,3,13,29,61,111,4.243243243243243
nintendo wii u console - 32gb black deluxe set,10,4,10,19,67,110,4.172727272727273
fallout 3,3,3,7,28,69,110,4.427272727272728
splatoon,8,2,4,10,85,109,4.486238532110092
resident evil 4,2,3,2,16,86,109,4.660550458715596
wii nunchuk controller - white,3,0,3,20,82,108,4.648148148148148
call of duty: ghosts - xbox one,18,3,20,20,47,108,3.6944444444444446
batman: arkham asylum - playstation 3,3,0,6,21,78,108,4.583333333333333
dishonored,0,8,11,25,63,107,4.336448598130841
rise of the tomb raider - xbox one,4,1,7,11,84,107,4.588785046728972
the legend of zelda: majora's mask 3d,2,1,2,8,94,107,4.785046728971962
fire emblem: awakening,1,1,8,5,92,107,4.738317757009346
shadow of the colossus - playstation 2,1,8,12,19,67,107,4.336448598130841
resistance 3 - playstation 3,5,3,12,28,58,106,4.235849056603773
super mario maker - nintendo wii u,5,0,5,8,88,106,4.6415094339622645
pokemon y,1,0,5,10,90,106,4.773584905660377
dying light - playstation 4,5,9,14,17,61,106,4.132075471698113
mass effect andromeda - pre-load - ps4 digital code,22,16,24,16,28,106,3.1132075471698113
batman: arkham city for playstation 3,2,1,4,13,86,106,4.69811320754717
dead rising 3,6,3,5,25,67,106,4.3584905660377355
assassin's creed ii: platinum hits edition,2,0,11,20,73,106,4.528301886792453
metroid prime,3,5,8,15,75,106,4.452830188679245
left 4 dead 2 - xbox 360,3,6,11,20,65,105,4.314285714285714
donkey kong country tropical freeze - nintendo wii u,6,1,2,18,78,105,4.533333333333333
xbox live 12 month gold membership card,2,0,4,6,93,105,4.79047619047619
16gb playstation vita memory card,3,3,17,18,64,105,4.304761904761905
hyrule warriors - nintendo wii u,4,1,5,13,81,104,4.596153846153846
official wii zapper with link's crossbow training,6,8,20,26,44,104,3.9038461538461537
resident evil 4 - playstation 2,5,3,5,9,82,104,4.538461538461538
mad max - playstation 4,4,2,12,23,62,103,4.330097087378641
dragon age inquisition - standard edition - playstation 4,4,4,16,23,56,103,4.194174757281553
xbox one 500gb console - assassin's creed unity bundle,11,3,6,15,68,103,4.223300970873787
nintendo 3ds compatible with 3ds / 3ds xl / 2ds ac adapter,5,0,2,10,86,103,4.669902912621359
luigi's mansion - gamecube,6,4,17,31,45,103,4.019417475728155
battlefield 4 - playstation 4,5,3,12,17,65,102,4.313725490196078
lost odyssey - xbox 360,2,4,18,36,42,102,4.098039215686274
rise of the tomb raider: 20 year celebration - playstation 4,6,2,3,14,77,102,4.509803921568627
metroid: other m,6,8,19,19,50,102,3.9705882352941178
the legend of zelda: twilight princess hd - wii u,1,0,3,11,87,102,4.794117647058823
doom 3,6,3,19,36,37,101,3.9405940594059405
kingdom hearts ii - playstation 2,0,3,5,17,76,101,4.643564356435643
mortal kombat x: greatest hits - playstation 4,4,5,12,19,61,101,4.267326732673268
xbox one stereo headset adapter,5,0,6,20,69,100,4.48
call of duty: black ops iii - standard edition - xbox one,17,8,11,22,42,100,3.64
mario kart ds,0,2,4,17,77,100,4.69
resident evil 6,13,14,20,18,34,99,3.4646464646464645
fable ii,6,5,19,33,36,99,3.888888888888889
max payne 3 - xbox 360,4,7,8,24,56,99,4.222222222222222
call of duty: advanced warfare - xbox one,10,6,12,16,55,99,4.01010101010101
star wars knights of the old republic - xbox,3,3,6,18,68,98,4.479591836734694
wii play,0,2,14,26,56,98,4.387755102040816
grand theft auto v - xbox 360,3,4,4,8,79,98,4.591836734693878
ratchet and clank future: tools of destruction - playstation 3,0,2,2,17,77,98,4.724489795918367
paper mario: sticker star,4,5,11,22,55,97,4.22680412371134
need for speed hot pursuit - playstation 3,7,1,17,15,57,97,4.175257731958763
wii remote controller,1,0,8,16,72,97,4.628865979381444
just cause 2 - playstation 3,0,0,10,24,63,97,4.546391752577319
super mario 64 ds,5,4,6,20,61,96,4.333333333333333
just cause 2 - xbox 360,6,2,4,26,58,96,4.333333333333333
metal gear solid 2: sons of liberty,2,6,10,22,56,96,4.291666666666667
quantum break - xbox one,8,8,16,13,50,95,3.9368421052631577
heavenly sword - playstation 3,2,8,13,28,44,95,4.094736842105263
ryse: son of rome xbox one,3,4,22,20,46,95,4.073684210526316
sega dreamcast console,1,2,2,14,76,95,4.705263157894737
rare replay - xbox one,5,3,6,15,65,94,4.404255319148936
õkami,2,2,6,14,70,94,4.574468085106383
dead space 2,0,1,6,20,66,93,4.623655913978495
alien: isolation - playstation 4,3,8,5,17,60,93,4.32258064516129
bowser amiibo (super mario bros series),3,0,2,9,79,93,4.731182795698925
shin megami tensei: persona 3 fes - playstation 2,4,2,4,18,65,93,4.483870967741935
need for speed: rivals,6,3,17,21,46,93,4.053763440860215
bioshock infinite - ps3 [digital code],1,2,10,13,67,93,4.537634408602151
watch dogs xbox one,1,7,16,22,47,93,4.150537634408602
playstation tv,6,4,16,25,41,92,3.989130434782609
pokemon alpha sapphire - nintendo 3ds,2,0,4,10,76,92,4.717391304347826
battlefield 4 - playstation 3,8,7,10,17,50,92,4.021739130434782
tom clancy's splinter cell conviction,5,2,11,29,45,92,4.163043478260869
logitech playstation 3 driving force gt racing wheel,4,2,6,38,42,92,4.217391304347826
far cry primal - playstation 4 standard edition,7,6,18,22,39,92,3.869565217391304
call of duty 4: modern warfare - xbox 360,2,1,6,14,69,92,4.5978260869565215
tom clancy's rainbow six vegas 2 - xbox 360,0,4,8,30,50,92,4.369565217391305
pokémon omega ruby - nintendo 3ds,2,0,3,6,81,92,4.782608695652174
fable - best of platinum - xbox (platinum),2,1,11,28,50,92,4.336956521739131
resident evil 4 - gamecube,0,0,3,10,78,91,4.824175824175824
dead space 3 limited edition,4,5,15,18,49,91,4.131868131868132
nier: automata - playstation 4,5,5,4,12,65,91,4.395604395604396
nintendo nunchuk controller - white,1,0,2,8,79,90,4.822222222222222
no more heroes,0,0,14,26,50,90,4.4
street fighter v - playstation 4 standard edition,34,11,10,8,27,90,2.811111111111111
battlefield 4 - xbox 360,13,10,13,17,37,90,3.611111111111111
mafia ii,0,8,20,32,30,90,3.933333333333333
titanfall 2 - playstation 4,3,3,6,11,66,89,4.50561797752809
playstation 3 60gb system,3,3,10,13,60,89,4.393258426966292
the legend of zelda: ocarina of time,1,2,1,6,79,89,4.797752808988764
dead rising - xbox 360,3,8,14,36,28,89,3.8764044943820224
ghostbusters: the video game - playstation 3,2,0,12,24,50,88,4.363636363636363
ps2 controller extension cable - 6 foot (bulk packaging),2,4,0,10,72,88,4.659090909090909
hori screen protective filter for nintendo new 3ds xl,6,2,1,9,70,88,4.534090909090909
grand theft auto v - xbox one,9,0,4,12,62,87,4.35632183908046
official nintendo wii wheel wii remote controller not included,0,0,6,12,69,87,4.724137931034483
battlefield 4 - xbox one,8,8,14,20,37,87,3.8045977011494254
thief - playstation 4,5,9,13,21,39,87,3.9195402298850577
bioshock - playstation 3,1,2,7,17,60,87,4.528735632183908
pokémon sun - nintendo 3ds,1,4,3,11,67,86,4.616279069767442
l. a. noire,2,5,13,30,36,86,4.0813953488372094
resident evil - gamecube,0,2,6,14,64,86,4.627906976744186
wii play with wii remote,6,7,16,35,22,86,3.697674418604651
star fox zero + star fox guard - nintendo wii u,7,6,15,16,42,86,3.9302325581395348
pokémon moon - nintendo 3ds,0,3,3,12,68,86,4.686046511627907
fear 2: project origin - pc,14,4,12,25,31,86,3.63953488372093
assassin's creed rogue- playstation 3,2,1,3,16,64,86,4.616279069767442
silent hill: homecoming - xbox 360,10,8,12,19,36,85,3.7411764705882353
dead space 2,1,0,4,22,58,85,4.6
wireless stereo headset - playstation 3,1,1,8,13,62,85,4.576470588235294
gears of war 4 - xbox one,6,5,14,13,47,85,4.0588235294117645
middle earth: shadow of mordor - xbox one,5,4,5,19,52,85,4.2823529411764705
star wars the force unleashed - xbox 360,3,7,12,34,29,85,3.929411764705882
sony playstation 3 blu-ray disc remote,3,7,8,26,41,85,4.117647058823529
official nintendo white classic gamecube controller,2,2,0,2,78,84,4.809523809523809
halo 5: guardians,16,4,14,12,38,84,3.619047619047619
"amazonbasics carrying case for nintendo - new 3ds xl, 3ds xl - red (officially licensed by nintendo)",0,1,3,14,66,84,4.726190476190476
gears of war: ultimate edition - xbox one,9,3,3,14,55,84,4.226190476190476
hitman absolution (digital code) - ps3 [digital code],2,5,5,20,51,83,4.36144578313253
sonic unleashed,2,6,10,24,40,82,4.146341463414634
animal crossing,2,3,8,17,52,82,4.390243902439025
destiny - standard edition - xbox one,12,8,15,12,35,82,3.6097560975609757
chrono trigger,1,2,2,7,70,82,4.7439024390243905
alpha protocol - playstation 3,9,8,4,30,31,82,3.8048780487804876
gamecube (jet black),2,5,6,16,53,82,4.378048780487805
call of duty: world at war greatest hits - playstation 3,0,3,6,17,55,81,4.530864197530864
super mario 64,1,2,2,9,67,81,4.716049382716049
max payne 3 - pc,10,10,14,14,33,81,3.617283950617284
god of war 3 remastered - playstation 4,5,1,5,13,56,80,4.425
sonic ultimate genesis collection - playstation 3,1,1,5,21,52,80,4.525
tom clancy's the division - xbox one,14,7,10,19,30,80,3.55
fallout 3: game of the year edition,2,1,1,10,66,80,4.7125
dead island - xbox 360,7,7,15,24,27,80,3.7125
ratchet & clank future: a crack in time - playstation 3,0,1,9,16,54,80,4.5375
minecraft - playstation 3,2,1,6,13,58,80,4.55
the elder scrolls v: skyrim special edition - ps4 [digital code],5,2,5,12,56,80,4.4
littlebigplanet - playstation 3,3,1,7,10,58,79,4.506329113924051
just cause 3 - playstation 4,8,7,10,12,42,79,3.9240506329113924
mario kart: double dash,1,3,3,15,57,79,4.569620253164557
left 4 dead - xbox 360,4,4,15,16,40,79,4.063291139240507
nintendo 3ds game card case 24 - black,0,1,0,9,69,79,4.848101265822785
sunset overdrive,4,7,4,9,55,79,4.3164556962025316
heavy rain: director's cut ps3,5,4,8,9,53,79,4.2784810126582276
playstation vita - wifi,6,2,2,16,53,79,4.367088607594937
batman: arkham origins - xbox 360,3,5,11,20,40,79,4.1265822784810124
driveclub (playstation 4),11,11,11,12,34,79,3.5949367088607596
pure - xbox 360,2,0,16,38,23,79,4.012658227848101
lego indiana jones: the original adventures - nintendo wii,2,2,0,22,52,78,4.538461538461538
the legend of zelda: twilight princess,3,2,6,12,55,78,4.461538461538462
dragon age 2 - xbox 360,6,10,19,17,26,78,3.6025641025641026
uncharted 3: drake's deception game of the year digital edition - ps3 [digital code],3,3,2,18,52,78,4.448717948717949
crysis 2,3,3,13,17,42,78,4.17948717948718
sid meier's civilization revolution - playstation 3,4,10,14,24,26,78,3.7435897435897436
assassin's creed: revelations,1,2,10,16,48,77,4.402597402597403
the legend of zelda: breath of the wild - wii u,3,2,6,2,64,77,4.584415584415584
enslaved: odyssey to the west - playstation 3,1,2,9,30,35,77,4.246753246753247
microsoft xbox wireless adapter for windows 10,2,0,2,7,66,77,4.753246753246753
brutal legend,0,2,20,28,27,77,4.038961038961039
lego indiana jones: the original adventures,0,6,11,18,41,76,4.2368421052631575
star wars: the force unleashed - nintendo wii,2,6,13,26,29,76,3.973684210526316
chrono cross - playstation,0,5,5,18,48,76,4.434210526315789
far cry 4 - xbox one,1,4,9,19,43,76,4.302631578947368
watch dogs 2 - playstation 4,3,2,9,20,42,76,4.2631578947368425
bravely default - nintendo 3ds,2,8,3,14,49,76,4.315789473684211
lego marvel super heroes - playstation 4,1,2,4,15,54,76,4.565789473684211
the legend of zelda: skyward sword with music cd,8,3,7,19,39,76,4.026315789473684
ratchet and clank: into the nexus - ps3,2,1,5,22,46,76,4.434210526315789
ghostbusters: the video game - xbox 360,0,10,9,36,20,75,3.88
tomb raider underworld,4,10,14,16,31,75,3.8
devil may cry,3,2,5,15,50,75,4.426666666666667
gran turismo 6,5,4,11,12,43,75,4.12
playstation vita protective film - two pack,2,1,5,9,58,75,4.6
nintendo wii u deluxe set: super mario bros u & luigi u (32 gb),5,0,5,3,62,75,4.56
nintendo ds bundle with metroid prime hunters demo,4,0,1,15,55,75,4.56
metal gear solid: the legacy collection,0,0,3,5,67,75,4.8533333333333335
medal of honor - xbox 360,6,6,18,18,27,75,3.72
resident evil zero - gamecube,1,1,5,25,43,75,4.44
battlefield 3 [download],16,9,10,19,20,74,3.2432432432432434
call of duty: infinite warfare - legacy edition - ps4 [digital code],20,7,6,7,34,74,3.3783783783783785
resident evil: operation raccoon city - playstation 3,4,7,12,12,39,74,4.013513513513513
dragon age: origins - xbox 360,3,5,10,19,37,74,4.108108108108108
the saboteur - xbox 360,3,6,12,22,31,74,3.972972972972973
house of the dead 2 & 3 return,8,0,12,18,36,74,4.0
soul calibur iv - xbox 360,0,0,6,26,42,74,4.486486486486487
ps3 gran turismo 5 xl edition,4,1,8,16,45,74,4.3108108108108105
ryse: son of rome day one edition - xbox one,7,5,10,19,33,74,3.891891891891892
command & conquer: red alert 3 - pc,34,8,12,2,18,74,2.4864864864864864
playstation portable (psp) value pack,5,6,7,12,44,74,4.135135135135135
half-life 2 - pc,11,3,9,11,39,73,3.8767123287671232
batman: arkham knight - xbox one,3,3,10,17,40,73,4.205479452054795
dark souls - xbox 360,4,4,6,15,44,73,4.2465753424657535
mafia iii - playstation 4,7,9,15,13,29,73,3.6575342465753424
motorstorm: pacific rift - playstation 3,3,0,10,8,52,73,4.4520547945205475
far cry - pc,4,8,7,13,41,73,4.082191780821918
medal of honor: warfighter - ps3,1,3,5,10,54,73,4.5479452054794525
bioshock 2 - playstation 3,1,1,6,23,41,72,4.416666666666667
call of duty 4: modern warfare - playstation 3,0,0,6,16,50,72,4.611111111111111
god of war 4 - ps4 [digital code],2,3,6,4,57,72,4.541666666666667
crysis 2 - playstation 3,2,0,9,13,48,72,4.458333333333333
super mario world,2,2,2,3,63,72,4.708333333333333
tomb raider: definitive edition - xbox one,1,1,4,10,56,72,4.652777777777778
xbox 360 pro console 20gb [old version],14,3,10,16,29,72,3.5972222222222223
halo wars - xbox 360,2,4,8,28,30,72,4.111111111111111
two worlds 2 - xbox 360,11,7,14,24,15,71,3.352112676056338
god of war 2 - playstation 2,1,1,2,12,55,71,4.676056338028169
final fantasy x-2,6,9,15,16,25,71,3.6338028169014085
god of war origins collection - playstation 3,0,1,1,13,56,71,4.746478873239437
lightning returns: final fantasy xiii,6,10,10,12,33,71,3.788732394366197
sid meier's civilization revolution - xbox 360 (greatest hits),4,4,4,30,29,71,4.070422535211268
sonic unleashed - playstation 3,10,2,8,16,35,71,3.9014084507042255
prototype - xbox 360,8,2,18,24,19,71,3.619718309859155
wolfenstein: the new order,5,2,6,17,40,70,4.214285714285714
sly cooper: thieves in time - playstation 3,1,2,6,11,50,70,4.5285714285714285
sonic adventure 2 battle - gamecube,2,3,3,17,45,70,4.428571428571429
pure - playstation 3,0,1,12,28,29,70,4.214285714285714
nintendo new 3ds xl - black,3,1,2,7,57,70,4.628571428571429
mario party 8,2,5,10,21,32,70,4.085714285714285
dragon quest viii: journey of the cursed king,2,2,8,12,46,70,4.4
resident evil: revelations,1,1,4,17,47,70,4.542857142857143
borderlands 2 - playstation 3,1,0,5,14,50,70,4.6
catherine - ps3 [digital code],3,2,3,12,50,70,4.485714285714286
fallout: new vegas - ultimate edition,1,1,1,9,58,70,4.742857142857143
resident evil: the umbrella chronicles,5,3,16,21,25,70,3.8285714285714287
wii motionplus,2,4,11,13,39,69,4.202898550724638
burnout paradise - playstation 3,2,4,3,22,38,69,4.304347826086956
killzone mercenary,1,0,5,8,55,69,4.681159420289855
star wars: the force unleashed,1,4,12,22,30,69,4.101449275362318
street fighter iv - xbox 360,3,4,10,12,40,69,4.188405797101449
nyko dual charge base high speed docking/charging station for xbox one/xbox one s controllers with two super fast rechargeable battery packs,8,5,3,10,42,68,4.073529411764706
yoshi's woolly world -  wii u,0,0,3,10,55,68,4.764705882352941
assassin's creed iii: liberation,1,5,9,19,34,68,4.176470588235294
battlefield hardline - playstation 4,7,2,19,19,21,68,3.661764705882353
crysis 3 - playstation 3,1,2,10,16,39,68,4.323529411764706
dragon age: origins - pc,2,7,7,16,36,68,4.132352941176471
bioshock,10,2,8,16,31,67,3.8358208955223883
resident evil 5 gold edition (digital) - ps3 [digital code],4,5,1,11,46,67,4.343283582089552
mortal kombat - playstation vita,0,1,2,6,58,67,4.8059701492537314
red faction guerrilla - xbox 360,1,4,10,29,23,67,4.029850746268656
resident evil: code veronica x - playstation 2,6,3,12,15,31,67,3.925373134328358
insten 3 screen protector + cloth + compatible with sony psp,7,4,2,8,46,67,4.223880597014926
final fantasy anthology - playstation,2,1,3,9,52,67,4.611940298507463
crysis - pc,4,10,13,17,23,67,3.671641791044776
littlebigplanet - game of the year edition playstation 3,1,2,4,8,52,67,4.611940298507463
f.e.a.r. 2: project origin - playstation 3,0,0,10,23,34,67,4.358208955223881
halo: combat evolved - pc,5,3,14,15,29,66,3.909090909090909
disney infinty cars playset pack lightning mcqueen and holley shiftwell,2,0,3,7,54,66,4.681818181818182
recore - xbox one,10,4,7,18,27,66,3.727272727272727
metal gear solid,2,1,2,10,51,66,4.621212121212121
the legend of zelda:  phantom hourglass,2,2,3,12,47,66,4.515151515151516
steam controller,4,5,9,10,38,66,4.106060606060606
mario party 10,7,5,7,12,35,66,3.9545454545454546
borderlands 2 - limited edition - playstation vita bundle,1,0,3,10,52,66,4.696969696969697
final fantasy type-0 hd - playstation 4,9,5,12,14,26,66,3.6515151515151514
captain toad:  treasure tracker,3,0,0,12,51,66,4.636363636363637
pspgo - piano black,12,9,6,17,22,66,3.4242424242424243
ratchet & clank collection,0,1,1,9,55,66,4.787878787878788
bayonetta 2 - nintendo wii u,3,0,2,3,57,65,4.707692307692308
kingdom hearts 3d dream drop distance,0,1,9,10,45,65,4.523076923076923
the legend of zelda: skyward sword,5,1,13,10,36,65,4.092307692307692
tom clancy's ghost recon: future soldier - xbox 360,4,5,7,23,26,65,3.953846153846154
tom clancy's rainbow six vegas 2 - playstation 3,2,2,6,18,37,65,4.323076923076923
tom clancy's splinter cell - xbox,0,2,5,9,49,65,4.615384615384615
tom clancy’s ghost recon wildlands - playstation 4,4,6,7,11,37,65,4.092307692307692
paper mario: the thousand-year door,2,1,2,12,48,65,4.584615384615384
destiny - standard edition - xbox 360,8,11,11,4,31,65,3.6
homefront - xbox 360,10,13,13,14,15,65,3.169230769230769
medal of honor frontline - playstation 2,4,7,7,22,25,65,3.876923076923077
gran turismo 3 a-spec,1,2,8,11,42,64,4.421875
devil may cry 4 - playstation 3,1,4,12,11,36,64,4.203125
dante's inferno - xbox 360,2,1,10,22,29,64,4.171875
lego batman,0,2,6,20,36,64,4.40625
medal of honor warfighter - xbox 360,5,7,8,17,27,64,3.84375
south park:  the stick of truth - xbox 360,0,1,3,12,48,64,4.671875
super mario galaxy (nintendo selects),0,0,3,8,53,64,4.78125
xbox 360 4gb console,2,1,6,7,48,64,4.53125
twisted metal - ps3 [digital code],1,7,12,13,31,64,4.03125
red dead redemption: game of the year edition - xbox one and xbox 360,3,1,5,8,47,64,4.484375
fallout: new vegas - playstation 3,7,7,14,11,25,64,3.625
the legend of zelda: a link to the past,1,1,0,2,59,63,4.857142857142857
xbox one wireless controller [without bluetooth],5,1,7,10,40,63,4.253968253968254
nintendo 64 system - video game console,4,1,6,11,41,63,4.333333333333333
microsoft xbox 360 wireless a/b/g network adapter,3,4,6,18,32,63,4.142857142857143
dragon age 2 - playstation 3,2,2,17,19,23,63,3.9365079365079363
darksiders - xbox 360,2,2,7,23,29,63,4.190476190476191
castlevania: lords of shadow 2 - ps3 [digital code],1,2,8,11,41,63,4.412698412698413
motorstorm - playstation 3,0,8,9,15,31,63,4.095238095238095
dark souls ii: scholar of the first sin - playstation 4,6,4,3,14,36,63,4.111111111111111
need for speed: most wanted,1,4,5,8,45,63,4.4603174603174605
the witcher 2: assassins of kings enhanced edition,3,4,9,7,40,63,4.222222222222222
goldeneye 007,2,0,0,7,53,62,4.758064516129032
doom - xbox one,7,2,7,3,43,62,4.17741935483871
far cry 3 - playstation 3,3,3,4,13,39,62,4.32258064516129
diablo iii,0,2,5,13,42,62,4.532258064516129
world of warcraft - mac / windows xp / mac os x,4,3,6,9,40,62,4.258064516129032
gamecube memory card 251,1,0,2,5,54,62,4.790322580645161
metal gear solid 3 snake eater - playstation 2,2,6,2,14,38,62,4.290322580645161
minecraft - playstation 4,4,1,2,8,47,62,4.5
need for speed most wanted - playstation 3,6,4,4,12,36,62,4.096774193548387
beastron a/v cable for nintendo wii,0,0,2,4,55,61,4.868852459016393
wii sports resort,0,2,3,17,39,61,4.524590163934426
xbox one media remote,4,0,3,10,44,61,4.475409836065574
prince of persia - playstation 3,3,4,10,20,24,61,3.9508196721311477
the last guardian - playstation 4,4,5,10,15,27,61,3.918032786885246
middle earth: shadow of mordor game of the year - playstation 4,2,3,4,10,42,61,4.426229508196721
kingdoms of amalur: reckoning - ps3 [digital code],2,5,6,15,33,61,4.180327868852459
brutal legend - xbox 360,0,8,10,27,16,61,3.8360655737704916
call of duty advanced warfare - day zero edition,7,3,8,10,33,61,3.9672131147540983
call of duty: infinite warfare - standard edition - playstation 4,12,4,9,15,21,61,3.4754098360655736
dark souls iii - playstation 4 standard edition,6,3,2,9,41,61,4.245901639344262
sunset overdrive day one edition - xbox one,3,4,4,7,43,61,4.360655737704918
pokken tournament - wii u,5,0,5,10,41,61,4.344262295081967
evolve - playstation 4,24,6,9,8,14,61,2.7049180327868854
playstation 3 dualshock 3 wireless controller (urban camouflage) - playstation 3,1,1,1,9,49,61,4.704918032786885
xbox 360 250gb console,3,1,3,4,49,60,4.583333333333333
super mario bros. 3,1,1,0,6,52,60,4.783333333333333
crackdown - xbox 360,0,5,14,16,25,60,4.016666666666667
deus ex: mankind divided - playstation 4,5,2,6,19,28,60,4.05
cta digital ps vita travel eva protective case,1,0,3,10,46,60,4.666666666666667
white knight chronicles international edition - playstation 3,8,8,10,22,12,60,3.3666666666666667
the legend of zelda: twilight princess (nintendo selects),0,1,2,10,47,60,4.716666666666667
call of duty 2 - xbox 360,1,2,3,11,43,60,4.55
lost planet: extreme condition - playstation 3,4,2,21,17,16,60,3.65
resistance: burning skies - playstation vita,0,5,4,15,36,60,4.366666666666666
xenoblade chronicles x,4,1,5,6,44,60,4.416666666666667
kinect sensor tv mounting clip - xbox 360,1,1,4,10,44,60,4.583333333333333
the elder scrolls v: skyrim legendary edition - playstation 3,2,3,7,2,46,60,4.45
memory card for wii console 64 mb (1019 blocks),2,0,4,8,46,60,4.6
the legend of zelda,3,1,3,7,46,60,4.533333333333333
super street fighter iv - playstation 3,1,0,4,18,36,59,4.491525423728813
far cry 3 - pc,3,8,4,13,31,59,4.033898305084746
orange box - xbox 360,1,0,1,15,42,59,4.6440677966101696
"the elder scrolls v: skyrim - legendary edition, xbox 360",2,2,1,6,48,59,4.627118644067797
destiny: the taken king - legendary edition - playstation 4,7,5,8,9,30,59,3.847457627118644
crysis 3 - xbox 360,5,3,11,11,29,59,3.9491525423728815
super smash bros. gamecube adapter for wii u,4,0,3,7,45,59,4.508474576271187
donkey kong country,0,0,1,6,52,59,4.864406779661017
just cause 2 - pc,5,4,12,10,28,59,3.8813559322033897
red faction guerrilla - playstation 3,7,3,8,14,27,59,3.864406779661017
kirby triple deluxe - nintendo 3ds,1,0,2,8,48,59,4.728813559322034
far cry 4 - ps3 [digital code],4,4,4,9,38,59,4.237288135593221
diablo iii,4,2,4,17,32,59,4.203389830508475
final fantasy chronicles: chrono trigger/final fantasy iv,1,1,2,14,41,59,4.576271186440678
silent hill 2,1,1,6,13,38,59,4.4576271186440675
assassin's creed: director's cut edition - pc,4,2,8,18,27,59,4.0508474576271185
super mario all stars,0,1,0,5,52,58,4.862068965517241
thief xbox one,5,5,9,14,25,58,3.8448275862068964
metal gear solid hd collection,0,2,2,6,48,58,4.724137931034483
wii fit plus with balance board,1,0,4,10,43,58,4.620689655172414
nyko wii charge station,7,4,4,17,26,58,3.8793103448275863
pokémon black version 2,1,1,5,11,40,58,4.517241379310345
call of duty: modern warfare 3 - pc,8,7,10,10,23,58,3.5689655172413794
playstation 4 console - destiny bundle [discontinued],2,1,1,9,45,58,4.620689655172414
killzone - playstation 2,4,0,15,11,28,58,4.017241379310345
left 4 dead - game of the year edition -xbox 360,4,3,8,7,36,58,4.172413793103448
nintendo 64 expansion pak,2,1,3,3,49,58,4.655172413793103
boom blox - nintendo wii,2,0,8,18,30,58,4.275862068965517
super mario world: super mario advance 2,0,0,4,7,47,58,4.741379310344827
sony playstation vita wifi,5,0,0,2,50,57,4.614035087719298
dying light - xbox one,2,4,1,14,36,57,4.368421052631579
ghost squad - nintendo wii,0,4,6,18,29,57,4.2631578947368425
portal 2 - playstation 3,3,0,1,11,42,57,4.56140350877193
mario kart: super circuit,2,2,7,10,36,57,4.333333333333333
super mario advance 4: super mario bros 3,1,1,5,8,42,57,4.56140350877193
the witcher 3: wild hunt - xbox one,3,2,6,6,40,57,4.368421052631579
mass effect 2 - pc,2,0,4,15,36,57,4.456140350877193
star wars rogue squadron ii: rogue leader,1,6,9,15,26,57,4.035087719298246
xbox 360 rechargeable battery 2-pack,2,3,6,5,41,57,4.4035087719298245
warhawk - playstation 3 (no headset),0,0,6,16,35,57,4.508771929824562
final fantasy origins final fantasy i & ii remastered editions - playstation,1,2,5,15,34,57,4.385964912280702
sleeping dogs - xbox 360,0,2,6,14,35,57,4.43859649122807
world of warcraft: wrath of the lich king expansion set - (obsolete),6,2,10,6,33,57,4.017543859649122
the evil within,3,4,10,12,28,57,4.017543859649122
sony twisted metal: black - playstation 2,1,2,2,15,37,57,4.491228070175438
titanfall - xbox 360,7,3,6,11,30,57,3.9473684210526314
titanfall 2 - xbox one,7,1,1,9,39,57,4.2631578947368425
batman: arkham origins blackgate - playstation vita,5,5,6,11,30,57,3.982456140350877
bully: scholarship edition,0,0,9,16,32,57,4.4035087719298245
plants vs zombies garden warfare(online play required) - xbox one,5,4,1,9,37,56,4.232142857142857
elder scrolls online: tamriel unlimited - playstation 4,14,4,7,11,20,56,3.3392857142857144
star wars knights of the old republic ii: the sith lords,0,2,17,23,14,56,3.875
dishonored 2 - playstation 4,4,2,6,12,32,56,4.178571428571429
playstation vita travel pouch,1,3,7,8,37,56,4.375
xbox 360 rechargeable controller battery pack white,10,0,3,6,37,56,4.071428571428571
kinect sensor with kinect adventures!,2,4,8,8,34,56,4.214285714285714
metro redux - xbox one,2,1,1,11,41,56,4.571428571428571
shenmue,0,4,5,8,39,56,4.464285714285714
dragon age: origins - playstation 3,3,6,4,18,25,56,4.0
madden nfl 13 - xbox 360,9,8,5,15,19,56,3.482142857142857
sonic generations - xbox 360,1,0,3,14,38,56,4.571428571428571
silent hill 3,1,2,7,15,31,56,4.303571428571429
medal of honor: allied assault - pc,3,0,5,15,33,56,4.339285714285714
the evil within - playstation 3,1,3,2,9,41,56,4.535714285714286
alice: madness returns - playstation 3,4,2,6,15,28,55,4.109090909090909
alien: isolation - xbox one,5,5,6,12,27,55,3.9272727272727272
mag online only - playstation 3,9,7,6,11,22,55,3.5454545454545454
assassin’s creed syndicate - xbox one,2,2,5,14,32,55,4.3090909090909095
assassin's creed: revelations,2,2,4,18,29,55,4.2727272727272725
vanquish - playstation 3,0,2,8,12,33,55,4.381818181818182
silent hill origins - playstation 2,0,4,6,24,21,55,4.127272727272727
eternal darkness: sanity's requiem,2,2,2,14,35,55,4.418181818181818
mass effect 3 [online game code],10,2,9,14,20,55,3.581818181818182
zoom for kinect - xbox 360,9,2,5,8,30,54,3.888888888888889
the witcher enhanced - pc,5,3,8,13,25,54,3.925925925925926
super paper mario,2,3,13,14,22,54,3.9444444444444446
final fantasy iii,2,2,6,18,26,54,4.185185185185185
gran turismo 4 - playstation 2,0,4,6,12,32,54,4.333333333333333
forza motorsport 4 - xbox 360,0,2,0,11,41,54,4.685185185185185
call of duty: black ops - pc,14,6,6,10,18,54,3.2222222222222223
pdp wired fight pad for wii u - mario,0,6,2,12,34,54,4.37037037037037
grand theft auto iv,26,4,4,8,12,54,2.5555555555555554
alone in the dark - xbox 360,17,13,13,7,4,54,2.4074074074074074
xenosaga - playstation 2,0,3,5,16,30,54,4.351851851851852
need for speed - playstation 4,16,3,4,4,27,54,3.425925925925926
new super luigi u,3,5,9,11,26,54,3.962962962962963
final fantasy xv - playstation 4,4,7,8,13,22,54,3.7777777777777777
silent hill,0,1,4,11,38,54,4.592592592592593
dragon age inquisition - standard edition - xbox one,4,4,6,9,31,54,4.092592592592593
tom clancy's ghost recon advanced warfighter - xbox 360,1,5,5,17,26,54,4.148148148148148
"lego: marvel super heroes, xbox 360",1,2,1,6,44,54,4.666666666666667
ps3 wireless keypad,1,4,6,12,30,53,4.245283018867925
metal gear rising revengeance - xbox 360,3,0,5,10,35,53,4.39622641509434
the legend of zelda: twilight princess,2,1,1,9,40,53,4.584905660377358
overwatch - origins edition - playstation 4,3,3,5,7,35,53,4.283018867924528
the legend of zelda: spirit tracks,3,4,5,12,29,53,4.132075471698113
kid icarus: uprising,3,3,2,11,34,53,4.320754716981132
nintendo ds lite onyx black,1,2,5,6,39,53,4.509433962264151
jak and daxter: the precursor legacy,1,0,7,12,33,53,4.433962264150943
hori retro mario hard pouch for new 3ds xl and nintendo 3ds xl,0,0,0,9,44,53,4.830188679245283
saints row iv,3,3,7,15,25,53,4.056603773584905
dmc devil may cry: definitive edition - playstation 4,3,0,6,9,35,53,4.377358490566038
manhunt - playstation 2,1,1,10,14,27,53,4.226415094339623
metal gear solid: the essential collection,2,2,0,6,43,53,4.622641509433962
the legend of dragoon - playstation,2,6,4,10,31,53,4.169811320754717
xbox 360 hard drive transfer cable,5,0,0,5,42,52,4.519230769230769
watch dogs - xbox 360,3,7,12,12,18,52,3.673076923076923
monster hunter 3 ultimate - nintendo wii u,3,5,4,5,35,52,4.230769230769231
game boy player,1,1,2,4,44,52,4.711538461538462
star wars: battlefront - deluxe edition - playstation 4,6,5,15,10,16,52,3.480769230769231
brink,21,11,6,7,7,52,2.3846153846153846
s.t.a.l.k.e.r.: shadow of chernobyl - pc,4,8,8,14,18,52,3.6538461538461537
"endless ocean: dive, discover, dream",0,2,6,24,20,52,4.1923076923076925
crysis 2 - pc,4,4,6,14,24,52,3.9615384615384617
devil may cry hd collection - playstation 3,2,0,3,14,33,52,4.461538461538462
donkey kong country returns 3d,2,0,2,12,36,52,4.538461538461538
borderlands: the handsome collection - playstation 4 by 2k games,1,0,2,9,40,52,4.673076923076923
nba 2k14 - playstation 4,3,3,8,4,34,52,4.211538461538462
hori duraflexi clear protector for nintendo new 3ds xl,0,3,2,8,39,52,4.596153846153846
fifa 14 - playstation 4,3,0,3,15,31,52,4.365384615384615
the sims 2 - pc,2,2,2,9,36,51,4.470588235294118
unit 13 - playstation vita,0,1,4,14,32,51,4.509803921568627
jak & daxter collection - playstation 3,2,1,0,7,41,51,4.647058823529412
soul calibur ii - gamecube,1,1,2,14,33,51,4.509803921568627
"need for speed: hot pursuit, xbox 360",2,3,8,12,26,51,4.117647058823529
final fantasy xiv: a realm reborn - pc,3,7,6,10,25,51,3.9215686274509802
call of duty: black ops ii - pc,5,3,8,15,20,51,3.823529411764706
dead rising 3: apocalypse edition,3,2,7,11,28,51,4.1568627450980395
call of duty: world at war - pc,2,5,12,11,21,51,3.8627450980392157
nintendo wii u deluxe set: super mario 3d world and nintendo land bundle - black 32 gb,1,1,3,9,37,51,4.568627450980392
elder scrolls online: tamriel unlimited - xbox one,10,5,5,9,22,51,3.549019607843137
amazonbasics heavy-duty vault case for playstation vita and vita slim (officially licensed by sony),2,0,3,9,37,51,4.549019607843137
dragon age origins: ultimate edition - playstation 3,3,2,1,12,33,51,4.372549019607843
need for speed: the run - playstation 3,0,4,7,11,29,51,4.2745098039215685
perfect dark,0,1,3,7,40,51,4.686274509803922
fire emblem fates: birthright - nintendo 3ds birthright edition,2,1,6,5,37,51,4.450980392156863
f.e.a.r. first encounter assault recon - xbox 360,0,4,7,20,20,51,4.098039215686274
xbox one s 2tb console - launch edition [discontinued],6,1,2,6,36,51,4.2745098039215685
state of emergency - playstation 2,8,13,11,10,9,51,2.980392156862745
the saboteur - playstation 3,0,2,4,26,19,51,4.215686274509804
star wars: the force unleashed ii - playstation 3,1,10,17,5,18,51,3.5686274509803924
god of war chains of olympus - sony psp,0,1,3,9,38,51,4.647058823529412
monster hunter 4 ultimate standard edition - nintendo 3ds,1,1,3,6,40,51,4.627450980392157
condemned 2: bloodshot - xbox 360,2,2,12,17,18,51,3.9215686274509802
gravity rush - playstation vita,1,0,5,5,39,50,4.62
the elder scrolls iv: oblivion - game of the year edition,1,3,3,9,34,50,4.44
mega man x collection - playstation 2,0,0,3,9,38,50,4.7
wet - playstation 3,4,10,9,8,19,50,3.56
playstation vr,5,1,5,10,29,50,4.14
destiny - standard edition - playstation 3 [digital code],11,5,7,3,24,50,3.48
tearaway,0,0,1,7,42,50,4.82
grand theft auto liberty city stories,1,1,4,10,34,50,4.5
madden nfl 16 - playstation 4,8,3,1,10,28,50,3.94
the legend of zelda: triforce heroes - 3ds,4,2,5,5,34,50,4.26
madden nfl 15 - playstation 4,2,7,2,11,28,50,4.12
lego star wars: the complete saga - nintendo wii,1,0,2,7,40,50,4.7
tales of symphonia - gamecube,0,0,3,7,40,50,4.74
ratchet & clank - playstation 2,2,1,2,9,36,50,4.52
playstation 4 universal media remote [old model],10,5,6,12,17,50,3.42
sleeping dogs: definitive edition- playstation 4,1,1,3,15,30,50,4.44
"beastron mario kart racing wheel for nintendo wii, 2 sets white color bundle",2,1,3,10,34,50,4.46
ratchet & clank up your arsenal - playstation 2,0,1,4,6,39,50,4.66
"lowpricenice premium high resolution component av cable for playstation 3 ps3, playstation 2 ps2",4,0,2,8,36,50,4.44
dragon quest heroes: the world tree’s woe and the blight below,2,6,4,13,25,50,4.06
resident evil: operation raccoon city - xbox 360,9,11,7,7,16,50,3.2
sonic unleashed - xbox 360,10,2,4,8,26,50,3.76
dark souls ii - playstation 3,3,1,2,6,38,50,4.5
splatoon 3-pack amiibo (splatoon series),1,0,4,1,44,50,4.74
littlebigplanet - playstation vita,1,0,2,5,42,50,4.74
rayman legends - playstation 4 standard edition,1,0,4,5,39,49,4.653061224489796
nyko intercooler stand - cooling attachment with short usb power cord for xbox one,1,0,7,5,36,49,4.530612244897959
the sims 2: freetime expansion pack,2,0,6,8,33,49,4.428571428571429
alice: madness returns - xbox 360,0,1,5,14,29,49,4.448979591836735
final fantasy x x-2 hd remaster  standard edition - playstation 3,4,2,1,3,39,49,4.448979591836735
grand theft auto: chinatown wars - nintendo ds,0,1,2,14,32,49,4.571428571428571
assassin's creed rogue- xbox 360,3,0,2,12,32,49,4.428571428571429
battlefield 4 [online game code],6,4,8,15,16,49,3.63265306122449
metroid fusion,0,1,1,11,36,49,4.673469387755102
mario kart 64,1,0,3,9,36,49,4.612244897959184
castlevania: symphony of the night,2,0,0,5,42,49,4.73469387755102
super mario advance,2,2,5,15,25,49,4.204081632653061
tom clancy's rainbow six vegas - xbox 360,0,0,5,14,30,49,4.510204081632653
dark souls iii: day 1 edition - playstation 4,2,1,2,4,40,49,4.612244897959184
ico,2,1,2,10,34,49,4.489795918367347
playstation 3 doubleshock iii wireless controller (black),4,1,4,12,28,49,4.204081632653061
condemned criminal origins - xbox 360,2,3,6,18,20,49,4.040816326530612
katamari damacy - playstation 2,1,1,3,12,32,49,4.489795918367347
sonic generations - playstation 3,3,0,4,12,30,49,4.346938775510204
metroid prime 2: echoes,0,2,5,10,32,49,4.469387755102041
final fantasy x/x-2 hd remaster limited edition,0,1,0,7,40,48,4.791666666666667
blue dragon - xbox 360,0,1,9,14,24,48,4.270833333333333
hyrule warriors: legends - nintendo 3ds,4,1,5,5,33,48,4.291666666666667
pokemon white version 2 - nintendo ds,0,0,1,10,37,48,4.75
nintendo 2ds - electric blue,1,0,1,9,37,48,4.6875
mario and luigi: dream team,2,0,3,7,36,48,4.5625
buyee 128mb memory card for sony playstation 2,1,0,0,5,42,48,4.8125
just dance 2 - nintendo wii,1,2,2,6,37,48,4.583333333333333
psp super travel case with pockets,1,1,1,8,37,48,4.645833333333333
forza motorsport 5,5,5,7,8,23,48,3.8125
animal crossing: wild world,2,2,1,12,31,48,4.416666666666667
too human - xbox 360,5,8,12,14,9,48,3.2916666666666665
tom clancy's rainbow six siege - xbox one,4,2,9,10,23,48,3.9583333333333335
skylanders trap team: echo character pack,1,2,1,1,43,48,4.729166666666667
sports champions 2 - playstation 3,0,3,4,15,26,48,4.333333333333333
jak ii - playstation 2,4,4,6,11,23,48,3.9375
gen usb charge cable for nintendo 3ds/dsi/dsixl,6,0,5,8,29,48,4.125
resident evil origins collection - playstation 4 standard edition,1,2,1,4,40,48,4.666666666666667
burnout 3 takedown - playstation 2,0,0,3,5,40,48,4.770833333333333
fear 2: project origin,4,2,6,24,12,48,3.7916666666666665
saints row (platinum hits),3,4,11,12,18,48,3.7916666666666665
star wars jedi knight 2: jedi outcast - pc,1,0,5,10,31,47,4.48936170212766
wwe 2k16 - playstation 4,3,3,3,21,17,47,3.978723404255319
datel action replay power saves pro - nintendo 3ds,7,1,4,3,32,47,4.1063829787234045
resident evil: outbreak - playstation 2,5,7,8,8,19,47,3.617021276595745
sonic the hedgehog - playstation 3,13,10,5,6,13,47,2.9148936170212765
bioshock infinite [download],1,1,4,13,28,47,4.404255319148936
mario party ds,0,0,8,11,28,47,4.425531914893617
fantasy life - 3ds,1,0,1,9,36,47,4.680851063829787
mortal kombat x - xbox one,3,0,6,9,29,47,4.297872340425532
game boy color - atomic purple,1,1,3,3,39,47,4.659574468085107
madden nfl 09 - xbox 360,0,2,8,16,21,47,4.191489361702128
xbox one wireless controller and play & charge kit (without 3.5 millimeter headset jack),3,2,0,7,35,47,4.468085106382978
resident evil 6 - playstation 4,5,2,8,10,22,47,3.893617021276596
gran turismo 5 prologue,0,2,6,9,30,47,4.425531914893617
the sims 2: double deluxe - pc,4,2,4,6,31,47,4.23404255319149
freedom wars - playstation vita,0,3,6,8,30,47,4.382978723404255
fallout 3: game of the year edition (pc),5,4,4,3,31,47,4.085106382978723
professor layton and the curious village - nintendo ds,0,2,4,14,27,47,4.404255319148936
star ocean: integrity and faithlessness - playstation 4,7,7,13,5,15,47,3.297872340425532
final fantasy x|x-2 hd remaster - playstation vita,2,1,3,3,38,47,4.574468085106383
fallout 3 - pc,5,4,6,9,23,47,3.872340425531915
tomodachi life,2,1,4,6,33,46,4.456521739130435
life is strange - playstation 4,2,1,2,7,34,46,4.521739130434782
battlefield bad company 2 - xbox 360,0,1,4,12,29,46,4.5
star wars battlefront ii - playstation 2,1,1,4,12,28,46,4.413043478260869
resident evil: revelations 2 - playstation 4,2,3,3,10,28,46,4.282608695652174
persona 5 - standard edition - playstation 4,3,1,6,6,30,46,4.282608695652174
simcity [instant access],23,6,3,8,6,46,2.3043478260869565
fallout 4 - pc,8,1,7,7,23,46,3.782608695652174
skylanders trap team: trap master gearshift character pack,1,0,1,2,42,46,4.826086956521739
house of the dead: overkill - nintendo wii,3,0,6,16,21,46,4.130434782608695
final fantasy iv,0,2,2,6,36,46,4.6521739130434785
monster hunter 3 ultimate - nintendo 3ds,1,3,2,5,35,46,4.521739130434782
call of duty: infinite warfare - xbox one legacy edition,12,3,7,9,15,46,3.260869565217391
resident evil: the mercenaries 3d,14,1,1,7,23,46,3.5217391304347827
fifa 15 - playstation 4,0,2,3,10,31,46,4.521739130434782
mafia ii - playstation 3,0,1,5,12,28,46,4.456521739130435
dead or alive 3,0,0,11,8,27,46,4.3478260869565215
far cry primal - xbox one standard edition,4,1,6,11,24,46,4.086956521739131
donkey kong 64 - nintendo 64,3,1,8,9,25,46,4.130434782608695
call of duty: game of the year edition - pc,2,1,0,12,31,46,4.5
onimusha warlords,0,3,6,17,20,46,4.173913043478261
condemned 2: bloodshot - playstation 3,4,2,8,16,16,46,3.8260869565217392
castlevania: lament of innocence,2,6,5,19,14,46,3.8043478260869565
geltabz performance thumb grips - playstation 4 and playstation 3,1,2,1,10,32,46,4.521739130434782
playstation 2 console (slim line version 1),4,1,4,8,29,46,4.239130434782608
wii remote plus - black,0,0,1,4,41,46,4.869565217391305
spec ops: the line - pc,1,2,7,18,18,46,4.086956521739131
sonic lost world wiiu,4,1,4,12,25,46,4.1521739130434785
socom: u.s. navy seals confrontation bundled with bluetooth headset - playstation 3,12,0,8,12,13,45,3.311111111111111
kingdom hearts re:chain of memories,2,1,8,12,22,45,4.133333333333334
"turtle beach - ear force px22 universal amplified gaming headset - ps3, xbox 360, pc",4,0,2,10,29,45,4.333333333333333
tales of xillia - playstation 3,0,2,3,5,35,45,4.622222222222222
ghostbusters: the video game - nintendo wii,3,2,4,16,20,45,4.066666666666666
hori splatoon protector for nintendo wii u,0,1,0,4,40,45,4.844444444444444
haze - playstation 3,4,8,10,11,12,45,3.422222222222222
ratchet & clank going commando,0,1,1,11,32,45,4.644444444444445
socom 4: u.s. navy seals - playstation 3,6,3,5,9,22,45,3.8444444444444446
dead space - pc,12,2,5,9,17,45,3.3777777777777778
simcity: limited edition,23,6,3,8,5,45,2.2444444444444445
far cry 4 - xbox 360,1,2,2,13,27,45,4.4
bionic commando - playstation 3,4,6,8,6,21,45,3.7555555555555555
the orange box - pc,7,2,5,4,27,45,3.933333333333333
lego batman 2: dc super heroes - xbox 360,2,0,2,11,30,45,4.488888888888889
mad max - xbox one,2,4,7,9,23,45,4.044444444444444
the elder scrolls iii: morrowind game of the year edition,3,1,8,5,28,45,4.2
nintendo selects: the legend of zelda ocarina of time 3d,1,0,0,4,40,45,4.822222222222222
nba 2k11 - playstation 3,0,1,3,10,31,45,4.5777777777777775
"turtle beach - ear force px22  - universal amplified gaming headset- ps3, xbox 360, pc - ffp [old version]",4,0,2,10,29,45,4.333333333333333
xbox 360 black play and charge kit,0,2,4,5,34,45,4.5777777777777775
conker's bad fur day,2,2,4,7,30,45,4.355555555555555
de blob - nintendo wii,0,2,2,15,26,45,4.444444444444445
final fantasy x x-2 hd remaster standard edition playstation 4,1,3,2,7,32,45,4.466666666666667
aliens: colonial marines - playstation 3,3,5,7,12,18,45,3.8222222222222224
prince of persia: the sands of time - playstation 2,1,0,2,12,30,45,4.555555555555555
mario & sonic at the olympic games for wii,1,2,11,9,22,45,4.088888888888889
animal crossing: amiibo festival bundle - wii u,6,3,7,8,21,45,3.7777777777777777
xcom: enemy unknown - xbox 360,1,1,6,11,25,44,4.318181818181818
wii classic controller,2,1,9,8,24,44,4.159090909090909
sonic and the secret rings - nintendo wii,3,2,12,7,20,44,3.8863636363636362
gravity rush remastered - playstation 4,0,1,3,8,32,44,4.613636363636363
resident evil 4 - playstation 4 standard edition,0,2,2,7,33,44,4.613636363636363
tales of symphonia: dawn of the new world,2,4,6,14,18,44,3.9545454545454546
prototype 2 - playstation 3,4,0,2,12,26,44,4.2727272727272725
spec ops: the line - playstation 3,0,1,3,15,25,44,4.454545454545454
tekken tag tournament - playstation 2,2,1,7,7,27,44,4.2727272727272725
"insten dual charging back stand docking station with led light indicator compatible with sony playstation ps3 / ps 3 slim controller, black",2,4,5,11,22,44,4.068181818181818
motorstorm apocalypse,1,2,6,11,24,44,4.25
destiny: the taken king - legendary edition - xbox one,7,2,6,8,21,44,3.772727272727273
playstation 3 dualshock 3 wireless controller (candy pink),1,0,2,0,41,44,4.818181818181818
brain age: train your brain in minutes a day!,3,1,6,16,18,44,4.0227272727272725
tom clancy’s ghost recon wildlands - xbox one,0,4,8,12,20,44,4.090909090909091
ninja gaiden,1,3,1,9,30,44,4.454545454545454
battlefield hardline - xbox one,5,5,8,11,15,44,3.590909090909091
nintendo gamecube controller (black),0,1,3,8,32,44,4.613636363636363
mlb 12 the show - playstation 3,1,2,2,11,28,44,4.431818181818182
kingdom hearts hd 2.5 remix - playstation 3,1,0,0,5,38,44,4.795454545454546
metroid prime 3: corruption,1,2,3,6,32,44,4.5
medal of honor [download],3,7,7,12,15,44,3.659090909090909
borderlands ultimate edition - ps3 [digital code],2,1,2,13,26,44,4.363636363636363
the walking dead - xbox 360,4,4,3,7,26,44,4.068181818181818
forza motorsport 3 - xbox 360,1,1,4,10,27,43,4.4186046511627906
pokemon white version,1,0,3,11,28,43,4.511627906976744
super smash bros.,0,1,2,5,35,43,4.72093023255814
dragon age 2 - pc,4,8,12,11,8,43,3.255813953488372
max payne - pc,2,1,9,8,23,43,4.1395348837209305
xbox core console usm,1,3,5,13,21,43,4.162790697674419
binary domain - playstation 3,0,0,4,10,29,43,4.5813953488372094
pokemon mystery dungeon: explorers of darkness,0,1,2,6,34,43,4.6976744186046515
super nintendo console (snes system),0,0,1,2,40,43,4.906976744186046
skylanders swap force: slobber tooth character,0,0,3,4,36,43,4.767441860465116
dead rising 2 - xbox 360,1,2,5,18,17,43,4.116279069767442
x-men origins: wolverine - uncaged edition - playstation 3,1,1,6,10,25,43,4.325581395348837
x-men origins: wolverine - uncaged edition - xbox 360,1,0,10,9,23,43,4.232558139534884
dragon quest builders - playstation 4,1,0,1,7,34,43,4.6976744186046515
aliens: colonial marines - xbox 360,16,11,2,6,8,43,2.511627906976744
the last story - nintendo wii,1,1,2,8,31,43,4.558139534883721
zettaguard wireless pc usb gaming receiver for xbox 360 compact disc,4,5,4,6,24,43,3.953488372093023
ninja gaiden 3: razor's edge - nintendo wii u,2,1,8,9,23,43,4.162790697674419
8gb playstation vita memory card,2,2,4,11,24,43,4.232558139534884
call of duty: infinite warfare - standard edition - xbox one,9,3,4,4,23,43,3.6744186046511627
god of war: ascension collector's edition - playstation 3,2,0,5,3,33,43,4.511627906976744
borderlands: the pre-sequel - xbox 360,3,2,5,13,20,43,4.046511627906977
street fighter x tekken - playstation 3,10,3,6,9,15,43,3.372093023255814
wwe 2k14 - playstation 3,4,0,0,15,24,43,4.27906976744186
sid meier's civilization v [download],8,8,7,10,10,43,3.13953488372093
ufc - playstation 4,4,6,11,4,18,43,3.604651162790698
amiibo marth (japanese import),0,0,0,2,41,43,4.953488372093023
red faction,2,1,3,13,23,42,4.285714285714286
rayman origins,0,0,3,5,34,42,4.738095238095238
ps3 starhawk,3,5,8,8,18,42,3.7857142857142856
infinite undiscovery - xbox 360,0,4,19,5,14,42,3.6904761904761907
house of the dead overkill - extended cut - playstation 3,2,0,1,11,28,42,4.5
nintendo wii u console 8gb basic set - white,4,2,6,9,21,42,3.9761904761904763
silent hill: book of memories - playstation vita,3,7,3,6,23,42,3.9285714285714284
the darkness,0,4,10,12,16,42,3.9523809523809526
army of two: platinum hits - xbox 360,1,3,4,17,17,42,4.095238095238095
sonic mega collection,0,1,1,9,31,42,4.666666666666667
xenoblade chronicles 3d - new nintendo 3ds,3,1,3,10,25,42,4.261904761904762
dreamgear comfort grip for your old nintendo 3ds xl,2,2,1,10,27,42,4.380952380952381
crisis core: final fantasy vii,2,2,7,10,21,42,4.095238095238095
simcity 4 deluxe edition - pc,2,2,5,10,23,42,4.190476190476191
tomb raider: underworld,0,0,9,10,23,42,4.333333333333333
darksiders ii - xbox 360,1,2,3,15,21,42,4.261904761904762
tom clancy's splinter cell chaos theory - xbox,1,0,1,2,38,42,4.809523809523809
logitech playstation 2 cordless action controller,3,0,1,2,36,42,4.619047619047619
star wars battlefront - playstation 2,1,1,5,11,24,42,4.333333333333333
tekken 4 - playstation 2,1,4,6,12,18,41,4.024390243902439
zelda ii: the adventure of link,3,0,4,8,26,41,4.317073170731708
warcraft iii battle chest - pc/mac,1,1,2,5,32,41,4.609756097560975
tales of xillia 2 - playstation 3,2,1,2,10,26,41,4.390243902439025
super princess peach,1,1,0,16,23,41,4.439024390243903
mlb 15: the show - playstation 4,4,1,7,10,19,41,3.951219512195122
the crew - playstation 4,3,2,8,9,19,41,3.951219512195122
dragon's crown - playstation vita,0,0,1,10,30,41,4.7073170731707314
starcraft battle chest - pc/mac,0,0,3,3,35,41,4.780487804878049
the legend of zelda: a link to the past (includes four swords adventure),2,0,1,3,35,41,4.682926829268292
final fantasy tactics: the war of the lions - sony psp,2,1,4,7,27,41,4.365853658536586
tom clancy's ghost recon advanced warfighter 2 - xbox 360,0,3,8,11,19,41,4.121951219512195
metro redux - playstation 4,2,1,3,8,27,41,4.390243902439025
mortal kombat: komplete edition - xbox 360,1,0,3,6,31,41,4.609756097560975
for honor - xbox one,4,5,4,14,14,41,3.707317073170732
cta digital ps vita hand grip,2,1,2,10,26,41,4.390243902439025
halo 2: limited collector's edition,3,2,3,7,26,41,4.2439024390243905
burnout paradise - xbox 360,2,3,8,9,19,41,3.975609756097561
toy story 3 the video game - playstation 3,0,1,2,14,24,41,4.487804878048781
playstation 3 energizer power & play charging system,0,0,1,4,36,41,4.853658536585366
super mario bros. 2,0,2,1,5,33,41,4.682926829268292
castlevania: dawn of sorrow,0,0,1,6,34,41,4.804878048780488
madden nfl 09 - playstation 3,4,2,10,18,7,41,3.5365853658536586
playstation portable core (psp 1000),4,3,6,10,18,41,3.8536585365853657
playstation 3 - 320 gb system/playstation move bundle,1,0,0,3,37,41,4.829268292682927
prince of persia: the forgotten sands - playstation 3,2,0,4,15,20,41,4.2439024390243905
pikmin 3,2,0,3,4,32,41,4.560975609756097
pdp kinect tv mount - xbox one,0,0,2,9,30,41,4.682926829268292
diablo iii: reaper of souls,7,0,2,10,22,41,3.975609756097561
game boy advance console in glacier,2,0,5,12,22,41,4.2682926829268295
wwe smackdown! here comes the pain - playstation 2,3,0,2,5,31,41,4.487804878048781
final fantasy vii: dirge of cerberus,1,3,15,5,17,41,3.8292682926829267
metroid prime trilogy: collector's edition,0,0,2,4,35,41,4.804878048780488
ninja gaiden sigma 2 (ps3),0,0,6,11,24,41,4.439024390243903
bioworld nintendo the legend of zelda ocarina of time 3d navi necklace,1,0,2,0,38,41,4.804878048780488
the sims 4 - pc/mac,6,7,8,4,15,40,3.375
final fantasy tactics,3,0,3,7,27,40,4.375
call of duty 3 - xbox 360,2,5,6,13,14,40,3.8
sniper elite iii - playstation 4 standard edition,0,4,5,5,26,40,4.325
dark void - playstation 3,4,3,11,4,18,40,3.725
paper mario,1,1,0,7,31,40,4.65
tom clancy's splinter cell double agent - xbox 360,2,3,4,13,18,40,4.05
just dance 2014 - nintendo wii,1,0,4,11,24,40,4.425
sly cooper and the thievius raccoonus - playstation 2,1,1,3,7,28,40,4.5
bully - playstation 2,0,0,2,10,28,40,4.65
ninja gaiden sigma - playstation 3,1,2,3,12,22,40,4.3
crackdown 2 - xbox 360,2,3,13,8,14,40,3.725
legendary - xbox 360,0,12,2,10,16,40,3.75
fable ii: limited collectors edition,4,2,6,12,16,40,3.85
call of duty: advanced warfare - xbox 360,6,3,3,8,20,40,3.825
xbox 360 live 12 month gold card plus 1 month bonus,1,0,4,4,31,40,4.6
silent hill 4:  the room - playstation 2,2,2,7,15,14,40,3.925
need for speed rivals - xbox one,5,3,5,10,17,40,3.775
f.e.a.r.: first encounter assault recon - pc,2,2,2,19,15,40,4.075
super mario kart,0,1,3,4,32,40,4.675
soul calibur 2 - playstation 2,1,0,1,13,25,40,4.525
forza horizon 3 - xbox one,1,2,0,8,29,40,4.55
midnight club: los angeles - playstation 3,0,2,12,11,15,40,3.975
lollipop chainsaw - xbox 360,2,0,7,11,20,40,4.175
fire emblem fates: conquest - nintendo 3ds,1,0,2,11,26,40,4.525
grid - playstation 3,5,0,4,6,25,40,4.15
crash bandicoot: the wrath of cortex,4,3,9,12,12,40,3.625
assassin's creed 2 - pc,17,3,2,3,15,40,2.9
lego indiana jones: the original adventures - playstation 3,0,0,2,14,24,40,4.55
rune factory 4 - nintendo 3ds,0,0,0,4,36,40,4.9
assassin's creed limited edition - playstation 3,0,2,8,4,26,40,4.35
prince of persia trilogy hd - playstation 3,6,3,2,6,23,40,3.925
madden nfl 25 - xbox 360,5,4,7,11,13,40,3.575
sega saturn system - video game console,2,1,4,4,29,40,4.425
star ocean till the end of time - playstation 2,3,4,6,13,14,40,3.775
crysis warhead - pc,17,3,2,7,11,40,2.8
dead island: game of the year edition -xbox 360,4,2,7,7,20,40,3.925
prey - pre-load - ps4 digital code,6,5,3,10,16,40,3.625
singularity - playstation 3,0,1,8,12,18,39,4.205128205128205
the last of us remastered - ps4 download card/voucher,0,0,0,5,34,39,4.871794871794871
legend of heroes: trails of cold steel - playstation 3,1,0,2,4,32,39,4.6923076923076925
"insten dual remote charging dock charger station with 2 rechargeable 2800mah batteries & led light indicator docking compatible with nintendo wii / wii u game controller, black",3,0,2,7,27,39,4.410256410256411
playstation tv dualshock 3 bundle,0,5,6,6,22,39,4.153846153846154
yoshi's island ds,1,0,7,9,22,39,4.3076923076923075
kirby & the rainbow curse,1,5,2,9,22,39,4.17948717948718
xbox one 1tb console - 3 games holiday bundle (gears of war: ultimate edition + rare replay + ori and the blind forest),8,2,1,2,26,39,3.923076923076923
xenogears - playstation,0,1,3,7,28,39,4.589743589743589
sonic adventure - sega dreamcast,0,1,2,13,23,39,4.487179487179487
fallout: new vegas ultimate edition - playstation 3,4,1,6,9,19,39,3.9743589743589745
insten gen 4 piece stylus pen set multi color for nintendo ds lite,0,0,1,8,30,39,4.743589743589744
playstation vita card case,0,0,1,4,34,39,4.846153846153846
wwe 2k15 - playstation 4,1,5,7,8,18,39,3.948717948717949
spider-man: web of shadows - playstation 3,1,2,2,14,20,39,4.282051282051282
resident evil: director's cut,0,1,4,8,26,39,4.512820512820513
battlefield bad company 2 [download],3,3,5,10,18,39,3.948717948717949
modnation racers - playstation3 (greatest hits),2,1,4,4,28,39,4.410256410256411
ps3 320gb uncharted 3 bundle,0,0,0,6,33,39,4.846153846153846
playstation 4 battlefield 4 launch day bundle,5,2,3,6,23,39,4.0256410256410255
lego marvel super heroes,1,0,3,10,25,39,4.487179487179487
paper mario: color splash - wii u standard edition,2,1,6,7,23,39,4.230769230769231
fifa 16 - standard edition - playstation 4,2,1,6,8,22,39,4.205128205128205
ninja gaiden sigma,2,3,5,7,22,39,4.128205128205129
patapon - sony psp,2,4,2,14,17,39,4.0256410256410255
mlb 13 the show - playstation 3,1,1,4,7,26,39,4.435897435897436
halo 2 - pc,4,3,9,7,16,39,3.717948717948718
ps3 500 gb assassin's creed iii bundle,1,1,1,2,34,39,4.717948717948718
nintendo selects: super mario 3d world,0,1,0,2,36,39,4.871794871794871
ps3 bluetooth headset,4,2,3,7,23,39,4.102564102564102
alpha protocol - xbox 360,4,0,9,12,14,39,3.8205128205128207
tomsenn kinect sensor tv mount clip for xbox one,0,0,0,4,35,39,4.897435897435898
dark sector - playstation 3,2,3,9,12,13,39,3.7948717948717947
amazing adventures: the lost tomb - pc,2,0,2,10,25,39,4.435897435897436
call of duty 4: modern warfare - pc,1,3,4,6,25,39,4.3076923076923075
spyro the dragon,1,1,1,5,31,39,4.641025641025641
wwe '13,3,1,3,13,19,39,4.128205128205129
fallout: new vegas - pc,4,4,8,11,11,38,3.5526315789473686
dishonored - pc,0,0,3,10,25,38,4.578947368421052
guitar hero aerosmith,7,2,16,6,7,38,3.1052631578947367
xbox one console - titanfall + kinect,2,0,1,6,29,38,4.578947368421052
spider-man - playstation 2,1,3,5,16,13,38,3.973684210526316
valkyria chronicles remastered: launch edition - playstation 4,0,0,0,7,31,38,4.815789473684211
rayman raving rabbids - nintendo wii,1,3,4,9,21,38,4.2105263157894735
call of duty: ghosts [online game code],5,5,6,7,15,38,3.5789473684210527
mortal kombat armageddon - playstation 2,2,2,5,12,17,38,4.052631578947368
spider-man 2 - playstation 2,0,1,5,12,20,38,4.342105263157895
mortal kombat: deadly alliance - playstation 2,1,0,3,14,20,38,4.368421052631579
devil may cry 2,2,8,9,9,10,38,3.4473684210526314
kirby's return to dream land,1,1,1,2,33,38,4.7105263157894735
thrustmaster t-flight hotas x flight stick,0,2,0,6,30,38,4.684210526315789
ultimate marvel vs. capcom 3 - playstation 3,0,1,4,7,26,38,4.526315789473684
pdp psvita trigger grips,0,3,3,8,24,38,4.394736842105263
destroy all humans - playstation 2,1,4,3,10,20,38,4.157894736842105
far cry 2 - xbox 360,2,1,14,5,16,38,3.8421052631578947
pikmin,0,2,5,8,23,38,4.368421052631579
pokemon - diamond version,2,1,3,10,22,38,4.2894736842105265
forza horizon - xbox 360,3,0,5,11,19,38,4.131578947368421
gen premium dual charging station with led light plus 2 high capacity rechargeable replacement battery and usb cable for nintendo wii remote control,4,4,0,10,20,38,4.0
soulcalibur 3 - playstation 2,2,1,3,11,21,38,4.2631578947368425
overwatch - origins edition - xbox one,5,3,1,4,25,38,4.078947368421052
sonic the hedgehog,0,0,1,6,31,38,4.7894736842105265
viking: battle for asgard - xbox 360,2,2,10,11,13,38,3.8157894736842106
dark sector - xbox 360,0,3,12,14,9,38,3.763157894736842
sony playstation 1 complete system console ps1 psx,4,0,3,6,25,38,4.2631578947368425
borderlands 2,2,2,3,10,21,38,4.2105263157894735
the sims 3: pets expansion pack,3,2,1,6,26,38,4.315789473684211
golden sun,0,0,3,10,25,38,4.578947368421052
turtle beach - ear force xo one amplified gaming headset - xbox one,6,3,3,9,17,38,3.736842105263158
oblivion (game of the year edition) -xbox 360,0,1,1,7,28,37,4.675675675675675
prince of persia - xbox 360,2,3,8,11,13,37,3.810810810810811
mario party 4,2,0,7,10,18,37,4.135135135135135
marvel: ultimate alliance,1,1,6,9,20,37,4.243243243243243
tom clancy's splinter cell pandora tomorrow - xbox,0,1,4,11,21,37,4.405405405405405
nintendo entertainment system control deck,1,1,1,2,32,37,4.702702702702703
black - playstation 2,1,3,3,6,24,37,4.324324324324325
call of duty advanced warfare - day zero edition,4,3,3,4,23,37,4.054054054054054
lord of the rings the two towers - playstation 2,1,2,5,13,16,37,4.108108108108108
enter the matrix - playstation 2,3,3,9,4,18,37,3.8378378378378377
need for speed hot pursuit 2 - playstation 2,0,0,4,9,24,37,4.54054054054054
nintendo 64 controller pak,4,0,1,4,28,37,4.405405405405405
wii sports resort,0,0,1,5,31,37,4.8108108108108105
devil may cry collection - xbox 360,0,0,1,11,25,37,4.648648648648648
shin megami tensei iv - nintendo 3ds,1,0,3,9,24,37,4.486486486486487
senran kagura estival versus - playstation 4,3,0,2,5,27,37,4.4324324324324325
wii u gamepad silicone jacket - black,1,0,2,11,23,37,4.486486486486487
dead rising 2 - playstation 3,4,1,9,12,11,37,3.675675675675676
army of two - playstation 3,0,3,6,15,13,37,4.027027027027027
madden nfl 16 - xbox one,3,2,6,6,20,37,4.027027027027027
playstation silver wired stereo headset,4,6,8,4,15,37,3.5405405405405403
rayman legends - playstation 3,0,0,0,11,26,37,4.702702702702703
just dance 3 [nintendo wii],0,0,1,6,30,37,4.783783783783784
madworld,1,0,7,14,15,37,4.135135135135135
carnival games - nintendo wii,2,1,9,7,18,37,4.027027027027027
borderlands: the handsome collection - xbox one,1,0,4,5,27,37,4.54054054054054
lost planet: extreme condition - xbox 360,1,1,13,11,11,37,3.810810810810811
tom clancy's splinter cell - playstation 2 (jewel case),1,1,4,13,18,37,4.243243243243243
perfect dark zero,4,4,9,11,9,37,3.4594594594594597
final fantasy xiii-2,4,2,4,11,16,37,3.891891891891892
dead or alive 5 last round - playstation 4,2,1,1,8,25,37,4.4324324324324325
the getaway - playstation 2,2,4,7,16,8,37,3.6486486486486487
bravely second: end layer - nintendo 3ds,3,2,3,4,25,37,4.243243243243243
xbox one chat headset,9,4,1,6,17,37,3.4864864864864864
forza motorsport 5 limited edition,4,2,5,4,22,37,4.027027027027027
dark souls ii - xbox 360,3,3,2,7,22,37,4.135135135135135
dragon age inquisition - deluxe edition -  playstation 4,0,1,3,10,23,37,4.486486486486487
homefront: the revolution - playstation 4,10,2,10,6,9,37,3.054054054054054
sonic riders zero gravity - nintendo wii,2,2,2,3,28,37,4.4324324324324325
resident evil 2,0,0,1,9,27,37,4.702702702702703
wet - xbox 360,2,4,12,11,8,37,3.5135135135135136
nintendo new 3ds xl - red [discontinued],1,1,2,8,24,36,4.472222222222222
nier - playstation 3,1,2,4,5,24,36,4.361111111111111
daxter,1,0,2,6,27,36,4.611111111111111
resonance of fate - playstation 3,2,2,5,6,21,36,4.166666666666667
nintendo 3ds xl duraflexi protector - red,0,0,1,5,30,36,4.805555555555555
metroid prime hunters,3,0,2,12,19,36,4.222222222222222
dance central 2 - xbox 360,0,0,1,9,26,36,4.694444444444445
madden nfl 12 - xbox 360,4,5,1,10,16,36,3.8055555555555554
xbox 360 quick charge kit,0,2,0,5,29,36,4.694444444444445
xbox 360 e 4gb console,2,1,1,7,25,36,4.444444444444445
rocksmith 2014 edition - playstation 3 (cable included),1,0,2,6,27,36,4.611111111111111
sonic the hedgehog 2,0,0,0,5,31,36,4.861111111111111
warcraft iii: reign of chaos - pc/mac,1,4,1,8,22,36,4.277777777777778
viking: battle for asgard - playstation 3,2,2,8,15,9,36,3.75
need for speed: most wanted,1,1,6,9,19,36,4.222222222222222
call of duty: advanced warfare - playstation 3,2,3,4,8,19,36,4.083333333333333
cooking mama - nintendo ds,0,1,7,9,19,36,4.277777777777778
splatterhouse - xbox 360,1,2,6,12,15,36,4.055555555555555
playstation portable 2000 system - piano black,1,0,3,12,20,36,4.388888888888889
xbox 360 wireless controller - matte black,1,0,2,5,28,36,4.638888888888889
lego lord of the rings - xbox 360,0,1,3,3,29,36,4.666666666666667
halo 5: guardians - limited edition (physical disc) - xbox one,0,1,6,8,21,36,4.361111111111111
final fantasy xiv: a realm reborn - playstation 3,8,3,3,7,15,36,3.5
saints row iv,0,5,5,9,17,36,4.055555555555555
ps3 little big planet 2 special edition,0,0,2,5,29,36,4.75
dead space extraction,1,0,6,11,18,36,4.25
star wars knights of the old republic ii: the sith lords,4,0,7,14,11,36,3.7777777777777777
star wars battlefront ii - xbox,0,0,2,6,28,36,4.722222222222222
mario & luigi superstar saga,2,1,2,3,28,36,4.5
call of duty 2 - pc,3,1,3,7,22,36,4.222222222222222
diablo iii: ultimate evil edition,1,2,5,8,20,36,4.222222222222222
borderlands: the pre-sequel - playstation 3,4,4,7,4,17,36,3.7222222222222223
playstation all-stars battle royale ps vita - ps vita [digital code],1,0,5,9,21,36,4.361111111111111
fifa soccer 12 - playstation 3,1,0,4,9,22,36,4.416666666666667
kingdom under fire: circle of doom - xbox 360,6,8,6,7,9,36,3.138888888888889
alpha protocol - pc,4,10,3,14,5,36,3.1666666666666665
castlevania,1,3,2,10,20,36,4.25
okami - playstation 2,1,4,1,4,26,36,4.388888888888889
tom clancy end war - xbox 360,2,1,7,6,20,36,4.138888888888889
wario land: shake it! - nintendo wii,1,2,3,6,24,36,4.388888888888889
remember me - xbox 360,2,4,6,14,10,36,3.7222222222222223
playstation 3 80gb metal gear solid 4: guns of the patriots bundle,0,0,2,0,34,36,4.888888888888889
guitar hero: on tour,0,0,0,16,19,35,4.542857142857143
max payne 2: the fall of max payne,1,1,3,8,22,35,4.4
golden sun: dark dawn,0,2,3,10,20,35,4.371428571428571
legobatman2: dc super heroes - playstation 3,0,0,3,9,23,35,4.571428571428571
teenage mutant ninja turtles iv: turtles in time,0,0,1,9,25,35,4.685714285714286
forza motorsport 6 - xbox one,4,2,3,6,20,35,4.0285714285714285
batman: arkham origins,0,1,3,5,26,35,4.6
dark cloud,2,5,8,7,13,35,3.6857142857142855
the secret world - pc,0,3,9,8,15,35,4.0
red dead revolver - playstation 2,2,2,8,6,17,35,3.9714285714285715
metal gear solid v: the phantom pain - playstation 3 day one edition,1,2,3,3,26,35,4.457142857142857
the elder scrolls online - pc/mac,9,0,10,1,15,35,3.3714285714285714
mabel amiibo (animal crossing series),0,0,0,3,32,35,4.914285714285715
wolfenstein - playstation 3,2,1,4,11,17,35,4.142857142857143
ps3 250gb uncharted 3: game of the year bundle,3,2,1,5,24,35,4.285714285714286
metal gear solid v: ground zeroes - playstation 3 standard edition,2,1,3,9,20,35,4.257142857142857
mario & luigi: paper jam - nintendo 3ds,0,0,5,7,23,35,4.514285714285714
fifa 14 - playstation 3,2,1,1,9,22,35,4.371428571428571
final fantasy xv deluxe edition - playstation 4,5,2,4,3,21,35,3.942857142857143
digimon story: cyber sleuth - playstation 4,2,3,3,6,21,35,4.171428571428572
resident evil 3: nemesis,0,2,3,7,23,35,4.457142857142857
the simpsons hit & run,1,0,3,15,16,35,4.285714285714286
call of duty: black ops iii - multiplayer edition - playstation 3,8,2,3,2,20,35,3.6857142857142855
true crime streets of la - playstation 2,1,2,8,15,9,35,3.8285714285714287
pdp pelican ps3 dual triggers with bonus silicone caps,3,0,1,1,30,35,4.571428571428571
marvel vs. capcom 3: fate of two worlds - playstation 3,2,3,6,6,18,35,4.0
nintendo dsi console - blue,1,0,0,4,30,35,4.771428571428571
super paper mario (nintendo selects),0,2,6,5,22,35,4.3428571428571425
diablo iii: ultimate evil edition,0,0,6,8,21,35,4.428571428571429
xbox 360 core console [old version],6,2,4,7,16,35,3.7142857142857144
super mario bros. / duck hunt,0,0,0,4,31,35,4.885714285714286
spore - pc/mac,13,10,2,3,7,35,2.4571428571428573
yoshi's island: super mario advance 3,0,1,1,4,29,35,4.742857142857143
shadows of the damned - playstation 3,1,2,4,10,18,35,4.2
playstation 4 black friday bundle - grand theft auto v and the last of us remastered,1,1,1,5,26,34,4.588235294117647
watch dogs 2 - xbox one,5,1,4,9,15,34,3.823529411764706
fortune street,1,1,4,7,21,34,4.352941176470588
wipeout 2048 - playstation vita,0,1,2,6,25,34,4.617647058823529
banjo-kazooie,0,1,1,3,29,34,4.764705882352941
brain age 2: more training in minutes a day!,0,0,6,11,17,34,4.323529411764706
star fox 64 (without rumble pak),0,1,2,7,24,34,4.588235294117647
madden nfl 17 -  standard edition - xbox one,4,1,6,8,15,34,3.8529411764705883
skylanders spyro's adventure starter pack - nintendo wii,2,0,5,11,16,34,4.147058823529412
active life outdoor challenge - nintendo wii,0,0,4,2,28,34,4.705882352941177
lego star wars: the complete saga - xbox 360,1,0,0,11,22,34,4.5588235294117645
devil may cry 3 - playstation 2,1,1,5,9,18,34,4.235294117647059
dragon age origins: ultimate edition - xbox 360,1,0,1,2,30,34,4.764705882352941
dead rising 4 - xbox one,3,4,6,4,17,34,3.823529411764706
ryse: legendary edition,0,1,2,9,22,34,4.529411764705882
j-stars victory vs+ - playstation 4,1,1,5,6,21,34,4.323529411764706
metal gear solid: the twin snakes,1,0,5,9,19,34,4.323529411764706
ps3 everybody dance,1,1,1,15,16,34,4.294117647058823
nba 2k16 - playstation 4,3,2,4,7,18,34,4.029411764705882
drakengard 3 - playstation 3,1,2,4,7,20,34,4.264705882352941
the sims 3 supernatural [instant access],1,1,1,3,28,34,4.647058823529412
doom 3,0,0,3,12,19,34,4.470588235294118
need for speed most wanted - xbox 360,1,2,1,10,20,34,4.352941176470588
wolfenstein - xbox 360,2,3,6,12,11,34,3.7941176470588234
the simpsons: road rage,1,8,6,11,8,34,3.5
mario classic color amiibo (super smash bros series),2,0,1,2,29,34,4.647058823529412
resident evil: the darkside chronicles,1,2,4,7,20,34,4.264705882352941
xbox one chatpad + chat headset (plugs directly into chatpad),1,1,3,1,28,34,4.588235294117647
lucina amiibo - japan import (super smash bros series),1,0,1,0,32,34,4.823529411764706
the wolf among us - playstation 4,0,0,0,5,29,34,4.852941176470588
far cry 4 - pc,3,2,4,8,17,34,4.0
lair - playstation 3,3,7,5,9,10,34,3.4705882352941178
pokemon platinum,1,0,3,3,27,34,4.617647058823529
forza horizon 2 for xbox one,2,0,0,3,29,34,4.676470588235294
xbox dvd movie playback kit,1,0,7,9,17,34,4.205882352941177
roller coaster tycoon - pc,0,1,2,9,22,34,4.529411764705882
chibi-robo amiibo - amazon exclusive,0,0,1,4,29,34,4.823529411764706
project gotham racing,2,0,8,9,15,34,4.029411764705882
animal crossing: happy home designer - 3ds,0,7,3,8,16,34,3.9705882352941178
gamecube memory card 1019,3,0,2,4,25,34,4.411764705882353
metal gear solid hd collection,1,0,4,6,23,34,4.470588235294118
diablo 2,0,3,7,5,19,34,4.176470588235294
tales of zestiria - playstation 3,2,2,3,6,21,34,4.235294117647059
fable anniversary,4,1,3,3,23,34,4.176470588235294
the walking dead survival instinct  - ps3 [digital code],6,2,5,6,15,34,3.6470588235294117
south park: the fractured but whole - playstation 4,0,2,1,10,21,34,4.470588235294118
metal gear solid v: ground zeroes - xbox one standard edition,4,5,6,3,16,34,3.6470588235294117
plants vs zombies garden warfare(online play required) - xbox 360,6,1,3,7,17,34,3.823529411764706
spyro: year of the dragon,1,0,2,3,28,34,4.676470588235294
elder scrolls iv oblivion - xbox 360 (platinum hits),0,3,2,6,23,34,4.4411764705882355
tales of symphonia chronicles - playstation 3,1,1,1,10,20,33,4.424242424242424
sonic mega collection plus,1,1,1,12,18,33,4.363636363636363
nba 2k13 - ps3 [digital code],3,1,3,5,21,33,4.212121212121212
the legend of zelda: the wind waker (hd deluxe set) for nintendo wii u,4,1,0,5,23,33,4.2727272727272725
nintendo 3ds screen protective filter,0,1,2,13,17,33,4.393939393939394
return to castle wolfenstein - pc,0,0,6,7,20,33,4.424242424242424
final fantasy iv the complete collection - sony psp,0,0,3,5,25,33,4.666666666666667
bound by flame - ps4 [digital code],4,5,7,8,9,33,3.393939393939394
muramasa rebirth - playstation vita,0,2,0,7,24,33,4.606060606060606
medal of honor airborne - pc,4,3,7,8,11,33,3.5757575757575757
forza horizon 2 for xbox one,1,0,2,3,27,33,4.666666666666667
the amazing spider-man 2 - playstation 4,2,1,4,11,15,33,4.090909090909091
mario tennis open,1,0,7,6,19,33,4.2727272727272725
madden nfl 17 - standard edition - playstation 4,4,1,2,2,24,33,4.242424242424242
dragon's dogma: dark arisen - xbox 360,1,1,2,10,19,33,4.363636363636363
ys: memories of celceta - playstation vita,0,0,2,3,28,33,4.787878787878788
playstation 3 sniper: ghost warrior,1,1,7,4,20,33,4.242424242424242
sin and punishment: star successor - nintendo wii,0,1,2,8,22,33,4.545454545454546
xbox 360 data transfer cable,1,0,2,6,24,33,4.575757575757576
mega man 2 - nintendo nes,1,0,0,3,29,33,4.787878787878788
nyko net connect for wii,0,2,2,2,27,33,4.636363636363637
folklore - playstation 3,1,1,8,12,11,33,3.9393939393939394
trenro av video cable cord for nintendo 64 n64 tv game,0,0,4,3,26,33,4.666666666666667
the lego movie videogame - playstation 4,0,3,3,6,21,33,4.363636363636363
playstation 3 dualshock 3 wireless controller - metallic gold,1,0,0,5,27,33,4.7272727272727275
assassin's creed revelations,0,3,9,12,9,33,3.8181818181818183
the incredible hulk,2,6,12,6,7,33,3.303030303030303
xbox one limited edition halo 5: guardians wireless controller,0,3,1,1,28,33,4.636363636363637
quake 4 - xbox 360,0,2,6,14,11,33,4.03030303030303
unreal tournament iii - playstation 3,1,2,1,10,19,33,4.333333333333333
grand theft auto: san andreas ( dvd-rom ) - pc,3,2,5,3,20,33,4.0606060606060606
yo-kai watch - 3ds,2,0,1,4,26,33,4.575757575757576
resident evil 2,0,0,0,4,29,33,4.878787878787879
ratchet & clank: size matters - playstation 2,10,2,7,2,12,33,3.121212121212121
radiant historia - nintendo ds,0,0,4,7,22,33,4.545454545454546
mercenaries: playground of destruction - playstation 2,3,1,1,9,19,33,4.212121212121212
tomb raider: underworld,2,0,6,9,16,33,4.121212121212121
singularity - xbox 360,0,3,9,10,11,33,3.878787878787879
nintendo 3ds - flame red,1,1,2,5,24,33,4.515151515151516
punch-out!!,1,0,3,9,20,33,4.424242424242424
grand theft auto: vice city - pc,1,2,1,3,26,33,4.545454545454546
the elder scrolls iii: morrowind,3,3,3,8,16,33,3.9393939393939394
pokemon stadium,2,1,4,2,24,33,4.363636363636363
sonic heroes - gamecube,1,2,4,13,13,33,4.0606060606060606
soul calibur - sega dreamcast,1,0,0,0,32,33,4.878787878787879
portal - pc,0,0,0,2,31,33,4.9393939393939394
the witcher 2: assassins of kings digital premium edition [download],1,2,3,8,19,33,4.2727272727272725
hot shots golf: world invitational,1,1,3,4,24,33,4.484848484848484
baldur's gate: dark alliance,0,1,2,15,15,33,4.333333333333333
resident evil 5 - standard edition - playstation 4,0,0,2,12,19,33,4.515151515151516
dragon quest iv: chapters of the chosen - nintendo ds,0,1,2,5,24,32,4.625
mercenaries 2: world in flames - playstation 3,4,3,4,4,17,32,3.84375
chrono trigger,0,0,1,1,30,32,4.90625
assassin's creed iv black flag - nintendo wii u,0,2,0,5,25,32,4.65625
disney infinity 3.0 edition: star wars darth vader figure,0,0,0,2,30,32,4.9375
playstation 2 memory card 8mb 2pk red/blue,1,0,2,5,24,32,4.59375
overwatch - origins edition - pc,3,3,3,6,17,32,3.96875
yoshi's woolly world bundle  - wii u,0,0,1,2,29,32,4.875
jak 3 - playstation 2,0,0,2,6,24,32,4.6875
gravity rush 2 - playstation 4,1,0,5,6,20,32,4.375
grand theft auto iv & episodes from liberty city: the complete edition,0,0,0,3,29,32,4.90625
xbox one x 1tb limited edition console - project scorpio edition [discontinued],1,0,2,1,28,32,4.71875
manhunt 2 - sony psp,5,2,7,5,13,32,3.59375
gioteck ex-01 bluetooth headset for ps3,2,2,2,4,22,32,4.3125
state of decay- year-one survival edition,3,3,1,6,19,32,4.09375
titanfall [online game code],2,5,4,8,13,32,3.78125
pokemon super mystery dungeon - nintendo 3ds standard edition,0,1,1,3,27,32,4.75
sonic generations - nintendo 3ds,3,2,0,10,17,32,4.125
pokemon: firered version,1,1,2,7,21,32,4.4375
mario & luigi: partners in time,0,0,1,11,20,32,4.59375
modnation racers: road trip,2,2,5,6,17,32,4.0625
thief - xbox 360,2,6,3,7,14,32,3.78125
duke nukem forever [download],5,4,7,4,12,32,3.4375
lego: marvel super heroes - nintendo wii u,2,0,2,6,22,32,4.4375
sins of a solar empire - pc,0,6,4,10,12,32,3.875
forza motorsport 2 - xbox 360,2,1,3,9,17,32,4.1875
assassin's creed iii - pc,2,2,7,8,13,32,3.875
dead or alive 5 ultimate - ps3,1,1,1,7,22,32,4.5
bloodborne collectors edition - playstation 4,0,0,1,3,28,32,4.84375
godzilla - playstation 4,6,2,7,3,14,32,3.53125
sonic adventure dx director's cut,1,3,4,7,17,32,4.125
rocksmith,0,1,3,13,15,32,4.3125
kinect rush: a disney pixar adventure - xbox 360,1,2,1,5,23,32,4.46875
playstation vita -  walking dead bundle,2,1,1,7,21,32,4.375
metal gear solid hd collection,2,1,1,6,22,32,4.40625
the orange box - playstation 3,2,0,1,6,23,32,4.5
call of juarez: bound in blood - playstation 3,3,1,5,5,18,32,4.0625
wii u fit meter,0,0,4,1,27,32,4.71875
powera moga pro power - electronic games,4,1,2,5,20,32,4.125
scarface the world is yours - playstation 2,0,1,6,5,20,32,4.375
kirby's dream collection: special edition,0,1,1,4,26,32,4.71875
aliens vs predator - xbox 360,1,3,10,7,11,32,3.75
your shape fitness evolved 2012,0,0,0,12,20,32,4.625
battlefield 2142 deluxe edition - pc,4,4,8,0,16,32,3.625
marvel: ultimate alliance 2,2,0,6,8,16,32,4.125
xbox one limited edition call of duty: advanced warfare bundle,3,1,1,4,23,32,4.34375
halo 3 limited edition -xbox 360,2,1,3,4,22,32,4.34375
dead or alive xtreme beach volleyball,3,4,7,7,11,32,3.59375
rock band 2 - xbox 360 (game only),0,1,3,5,23,32,4.5625
madden nfl 25 - playstation 4,1,1,6,7,17,32,4.1875
afro samurai - playstation 3,0,2,9,8,13,32,4.0
we ski - nintendo wii,2,0,6,4,20,32,4.25
wii party u,1,1,4,6,20,32,4.34375
rocksmith 2014 edition - xbox 360 (cable included),1,2,0,5,24,32,4.53125
afro samurai - xbox 360,0,4,13,5,10,32,3.65625
warioware: touched! - nintendo ds,0,1,4,11,15,31,4.290322580645161
[2 pack] slickblue flexible silicone protective skin case for sony ps4 game controller - blue [playstation 4],0,3,1,8,19,31,4.387096774193548
xbox 360 headset,4,2,9,5,11,31,3.5483870967741935
sniper: ghost warrior - xbox 360,3,5,4,7,12,31,3.6451612903225805
puppeteer - playstation 3,0,0,3,5,23,31,4.645161290322581
nintendo selects: donkey kong country: tropical freeze,0,1,2,6,22,31,4.580645161290323
transformers devastation - playstation 4,1,4,7,4,15,31,3.903225806451613
age of empires 2: age of kings - pc,0,1,4,8,18,31,4.387096774193548
resident evil deadly silence - nintendo ds,0,0,4,6,21,31,4.548387096774194
silent hill origins - sony psp,0,1,3,6,21,31,4.516129032258065
4x wii/gamecube extension cables,1,0,3,3,24,31,4.580645161290323
fatal frame,0,1,3,4,23,31,4.580645161290323
mirror's edge catalyst - playstation 4,2,3,6,2,18,31,4.0
kinect disneyland adventures - xbox 360,2,1,3,9,16,31,4.161290322580645
mario party 5,0,1,5,8,17,31,4.32258064516129
lego star wars: the complete saga- greatest hits - playstation 3,0,0,0,3,28,31,4.903225806451613
afterglow wired controller for xbox 360 - green,2,1,3,6,19,31,4.258064516129032
pokemon sapphire version - game boy advance,0,2,4,9,16,31,4.258064516129032
shinobi,1,4,7,9,10,31,3.7419354838709675
monster hunter generations - nintendo 3ds standard edition,1,1,2,2,25,31,4.580645161290323
sonic the hedgehog - xbox 360,8,3,3,5,12,31,3.3225806451612905
metroid,1,1,2,3,24,31,4.548387096774194
the evil within - xbox 360,0,3,5,4,19,31,4.258064516129032
scribblenauts - nintendo ds,0,4,5,13,9,31,3.870967741935484
street fighter anniversary collection,0,0,6,6,19,31,4.419354838709677
star wars: battlefront - deluxe edition - xbox one,9,3,6,1,12,31,3.129032258064516
crash bandicoot,1,4,7,7,12,31,3.806451612903226
atari 2600 video computer system console,2,0,0,0,29,31,4.741935483870968
playstation vr launch bundle [discontinued],4,3,1,5,18,31,3.967741935483871
the sims 3 seasons,1,0,3,4,23,31,4.548387096774194
left 4 dead,5,3,4,7,12,31,3.5806451612903225
professor layton and the diabolical box,0,1,3,4,23,31,4.580645161290323
ultimate marvel vs capcom 3 - playstation vita,0,1,3,8,19,31,4.451612903225806
super mario world 2: yoshi's island,0,2,2,3,24,31,4.580645161290323
nba 2k15 - xbox one,2,3,2,5,19,31,4.161290322580645
metro last light - playstation 3,0,1,7,9,14,31,4.161290322580645
aliens: colonial marines - pc (standard edition),10,2,9,3,7,31,2.838709677419355
parasite eve,1,1,2,11,16,31,4.290322580645161
dead or alive dimensions,0,0,0,9,22,31,4.709677419354839
powera amiibo question block case,1,1,1,3,25,31,4.612903225806452
mercenaries 2: world in flames - xbox 360,1,3,6,10,11,31,3.870967741935484
grid - xbox 360,4,0,6,7,14,31,3.870967741935484
nintendo super smash bros. black classic gamecube controller,0,0,0,1,30,31,4.967741935483871
xbox one kinect sensor with dance central spotlight (discontinued),6,1,5,4,15,31,3.6774193548387095
dualshock 4 wireless controller for playstation 4 - 20th anniversary edition,2,0,0,3,26,31,4.645161290322581
socom us navy seals: confrontation,10,3,2,2,14,31,3.225806451612903
wolfenstein: the new order - pc,2,1,3,5,20,31,4.290322580645161
phoenix wright: ace attorney - nintendo ds,2,0,0,11,18,31,4.387096774193548
microsoft xbox 360 component hd av cable,1,0,1,6,23,31,4.612903225806452
metal gear solid peace walker,1,0,3,3,23,30,4.566666666666666
resident evil 3: nemesis - gamecube,1,1,5,8,15,30,4.166666666666667
aliens vs predator - playstation 3,0,3,5,6,16,30,4.166666666666667
wwe smackdown vs raw 2009,2,4,10,2,12,30,3.6
kingdom hearts 358/2 days - nintendo ds,0,0,3,5,22,30,4.633333333333334
the elder scrolls iii: morrowind (game of the year edition),2,3,3,3,19,30,4.133333333333334
pokemon ruby version - game boy advance,0,1,5,7,17,30,4.333333333333333
wwe smackdown vs raw 2009,0,0,4,6,20,30,4.533333333333333
skies of arcadia : legends,0,0,0,10,20,30,4.666666666666667
tekken 6 - xbox 360,1,3,4,10,12,30,3.966666666666667
grand theft auto double pack: grand theft auto iii / grand theft auto: vice city,0,0,2,6,22,30,4.666666666666667
resident evil 2 - gamecube,1,1,4,5,19,30,4.333333333333333
silent hill: shattered memories,2,0,4,12,12,30,4.066666666666666
ea sports active - nintendo wii,1,0,1,8,20,30,4.533333333333333
risen - pc,2,3,4,10,11,30,3.8333333333333335
contra 4,0,0,1,3,26,30,4.833333333333333
sonic and the black knight - nintendo wii,2,1,2,6,19,30,4.3
xenosaga episode ii: jenseits von gut und bose - playstation 2,1,3,9,8,9,30,3.7
gears of war 2 limited edition -xbox 360,0,0,2,6,22,30,4.666666666666667
f-zero gx,1,0,1,6,22,30,4.6
mega man anniversary collection - playstation 2,0,0,2,2,26,30,4.8
lost planet 2 - playstation 3,2,3,4,7,14,30,3.933333333333333
007 quantum of solace - playstation 3,1,1,5,12,11,30,4.033333333333333
the sims 2: kitchen & bath interior design stuff - pc,0,4,4,6,16,30,4.133333333333334
james bond 007: quantum of solace - xbox 360,0,2,4,11,13,30,4.166666666666667
golden axe: beast rider - xbox 360,8,6,7,5,4,30,2.7
xbox 360 core console [old version],6,2,4,3,15,30,3.6333333333333333
shin megami tensei nocturne,0,1,2,7,20,30,4.533333333333333
namco ace combat 4 shattered skies,0,1,3,13,13,30,4.266666666666667
onechanbara z2: chaos - 'banana split' edition - playstation 4,1,0,4,9,16,30,4.3
xbox 360 wireless controller -  camouflage,0,0,1,4,25,30,4.8
playstation 2x network adaptor,2,1,2,4,21,30,4.366666666666666
72 pin connector for nes 8 bit nintendo system (bulk packaging),4,2,2,2,20,30,4.066666666666666
just dance 2014 - xbox 360,1,0,2,7,20,30,4.5
fight night champion - playstation 3,2,2,5,5,16,30,4.033333333333333
nintendo super smash bros palutena amiibo,0,0,0,0,30,30,5.0
the sims 2: bon voyage - pc cd-rom (expansion pack),2,0,5,3,20,30,4.3
call of duty: ghosts - nintendo wii u,1,1,3,9,16,30,4.266666666666667
mighty no. 9 - playstation 4,9,7,1,4,9,30,2.9
project gotham racing 3 - xbox 360,0,4,3,9,14,30,4.1
xbox one 500gb console -  halo: the master chief collection bundle,5,0,4,3,18,30,3.966666666666667
xbox one 1tb console - limited edition halo 5: guardians bundle,6,0,3,4,17,30,3.8666666666666667
borderlands 2: game of the year edition,1,0,2,3,24,30,4.633333333333334
darksiders 2: deathinitive edition - playstation 4 standard edition,1,1,2,10,16,30,4.3
wwe '12,2,1,2,11,14,30,4.133333333333334
elder scrolls iv: oblivion,4,0,2,4,20,30,4.2
super mario rpg: legend of the seven stars,1,1,2,4,22,30,4.5
ducktales - remastered - wii u,0,0,5,9,16,30,4.366666666666666
final fantasy (psp),0,1,2,9,18,30,4.466666666666667
dead space 3 limited edition,2,5,1,4,18,30,4.033333333333333
neverwinter nights 2,4,7,7,5,7,30,3.1333333333333333
killer instinct combo breaker pack - xbox one,1,1,0,2,26,30,4.7
the elder scrolls v: skyrim legendary edition - pc,1,1,1,3,24,30,4.6
homefront: the revolution - xbox one,5,5,3,9,8,30,3.3333333333333335
mafia iii - xbox one,8,3,3,7,9,30,3.2
deus ex human revolution: director's cut - nintendo wii u,1,1,1,9,18,30,4.4
disney infinity starter pack wii u,2,0,1,6,21,30,4.466666666666667
wii component video cable,0,0,3,10,17,30,4.466666666666667
energizer 3x charge station for wii u,1,1,2,7,19,30,4.4
amazing spider-man,0,0,3,6,21,30,4.6
lumines: electronic symphony - playstation vita,1,1,5,3,20,30,4.333333333333333
black duke controller [official],6,4,2,6,12,30,3.466666666666667
aliens versus predator 2 - pc,0,2,3,11,14,30,4.233333333333333
marvel’s spider-man - playstation 4,1,0,1,2,26,30,4.733333333333333
shovel knight amiibo - nintendo wii u/ 3ds,1,0,1,3,25,30,4.7
playstation 3 dualshock 3 wireless controller (classic white),3,0,3,3,21,30,4.3
grand theft auto: the trilogy (grand theft auto iii/ grand theft auto: vice city / grand theft auto: san andreas),0,0,1,3,26,30,4.833333333333333
wwe '13,1,1,6,9,13,30,4.066666666666666
ratchet & clank: size matters - sony psp,1,0,4,4,20,29,4.448275862068965
call of duty 3 - playstation 3,0,0,5,9,15,29,4.344827586206897
hawx - xbox 360,2,2,5,6,14,29,3.9655172413793105
rogue galaxy - playstation 2,1,0,6,7,15,29,4.206896551724138
rayman origins - playstation vita,0,0,0,4,25,29,4.862068965517241
sly cooper: thieves in time - ps vita [digital code],0,0,2,3,24,29,4.758620689655173
tom clancy's hawx - playstation 3,0,0,6,15,8,29,4.068965517241379
fallout 3 collector's edition -xbox 360,0,0,0,2,27,29,4.931034482758621
dreamgear- playstation 4 charge and play premium connection cable- perfect for charging dualshock4 controllers,2,1,2,4,20,29,4.344827586206897
mass effect 3 collector's edition -xbox 360,3,3,2,8,13,29,3.8620689655172415
madden nfl 15 - xbox one,2,3,5,5,14,29,3.896551724137931
sonic chronicles: the dark brotherhood - nintendo ds,0,0,4,8,17,29,4.448275862068965
the sims 2 seasons expansion pack - pc,0,0,1,5,23,29,4.758620689655173
datel max playstation 2 action replay,2,0,4,5,18,29,4.275862068965517
james bond 007 agent under fire - gamecube,0,0,8,11,10,29,4.068965517241379
the witcher 2: assassins of kings enhanced edition,1,1,5,5,17,29,4.241379310344827
mario party: island tour,0,3,2,8,16,29,4.275862068965517
wwe 2k14 - xbox 360,2,0,5,4,18,29,4.241379310344827
tom clancy's splinter cell blacklist - nintendo wii u,0,0,1,7,21,29,4.689655172413793
final fantasy tactics advance,2,2,3,8,14,29,4.0344827586206895
fatal frame 2: crimson butterfly,0,1,4,5,19,29,4.448275862068965
dead space 2 [instant access],3,1,3,9,13,29,3.9655172413793105
nintendo 3ds xl - black [old model],1,0,2,4,22,29,4.586206896551724
the walking dead - playstation vita,0,3,3,5,18,29,4.310344827586207
civilization 3 - pc,1,2,6,6,14,29,4.0344827586206895
ps3 component av cable,1,1,1,3,23,29,4.586206896551724
stranglehold,2,4,2,8,13,29,3.896551724137931
black & white - pc,5,3,7,4,10,29,3.3793103448275863
battlefield 2 - pc,0,2,3,9,15,29,4.275862068965517
max payne - xbox,0,0,5,11,13,29,4.275862068965517
command and conquer the ultimate collection [online game code],1,2,1,3,22,29,4.482758620689655
f.e.a.r. first encounter assault recon - playstation 3,1,1,7,6,14,29,4.068965517241379
tony hawk's pro skater 3,1,1,3,7,17,29,4.310344827586207
lego batman 3: beyond gotham - playstation 4,1,0,3,2,23,29,4.586206896551724
super metroid,1,0,0,2,26,29,4.793103448275862
reflet amiibo - japan import (super smash bros series),0,0,2,0,27,29,4.862068965517241
dragon quest viii: journey of the cursed king - nintendo 3ds,2,0,1,1,25,29,4.620689655172414
hot shots golf: out of bounds - playstation 3,0,4,2,8,15,29,4.172413793103448
mortal kombat deception - playstation 2,0,3,3,3,20,29,4.379310344827586
time splitters 2 - playstation 2,0,3,2,6,18,29,4.344827586206897
yakuza 4 - playstation 3,0,1,5,5,18,29,4.379310344827586
tatsunoko vs. capcom: ultimate all-stars - nintendo wii,1,0,0,7,21,29,4.620689655172414
tekken 3,0,1,3,5,20,29,4.517241379310345
plants vs zombies garden warfare(online play required) - playstation 4,2,0,1,5,21,29,4.482758620689655
wii bundle with wii sports & wii sports resort - white,1,1,1,2,24,29,4.620689655172414
ratchet deadlocked - playstation 2,0,1,3,6,19,29,4.482758620689655
zero suit samus amiibo (super smash bros series),1,0,0,1,27,29,4.827586206896552
siren - playstation 2,1,1,7,8,12,29,4.0
final fantasy explorers - nintendo 3ds,2,4,6,7,10,29,3.6551724137931036
deadpool - playstation 4,1,1,2,7,18,29,4.379310344827586
"nintendo amiibo series shulk collectible figure, 7cm",0,0,0,2,27,29,4.931034482758621
devil may cry 4 - xbox 360,0,2,2,10,15,29,4.310344827586207
world of warcraft: the burning crusade expansion set - (obsolete),3,0,3,5,18,29,4.206896551724138
clive barker's jericho - xbox 360,0,2,7,12,8,29,3.896551724137931
ninja gaiden black,1,0,3,1,24,29,4.620689655172414
shadow warrior - playstation 4,0,2,2,9,16,29,4.344827586206897
bourne conspiracy - playstation 3,0,2,4,9,14,29,4.206896551724138
fifa 17 - playstation 4,2,0,1,6,20,29,4.448275862068965
battleborn - playstation 4,2,4,4,6,13,29,3.8275862068965516
kirby mass attack,0,1,0,8,20,29,4.620689655172414
contra: shattered soldier,0,1,4,10,14,29,4.275862068965517
super mario bros. deluxe,1,0,3,1,23,28,4.607142857142857
tekken 7 -  ps4 digital code,8,3,8,2,7,28,2.892857142857143
castlevania: circle of the moon,2,1,3,6,16,28,4.178571428571429
matney 2 pack xbox 360 rechargeable battery + charging station black,3,2,3,5,15,28,3.9642857142857144
gamecube wavebird wireless controller - platinum,0,0,2,6,20,28,4.642857142857143
playstation 3 80gb motorstorm bundle,1,0,1,6,20,28,4.571428571428571
resident evil 7 biohazard - xbox one,3,1,2,4,18,28,4.178571428571429
pokemon leaf green version,1,1,0,6,20,28,4.535714285714286
sonic rush,1,2,2,7,16,28,4.25
playstation 4 500gb console - call of duty black ops iii bundle [discontinued],2,1,2,4,19,28,4.321428571428571
disney infinity starter pack ps3,2,1,1,5,19,28,4.357142857142857
dying light: the following - enhanced edition - playstation 4,2,1,3,4,18,28,4.25
psp traveler case,4,0,2,4,18,28,4.142857142857143
nintendo selects: pikmin 3,2,1,2,0,23,28,4.464285714285714
gold's gym cardio workout - nintendo wii,2,0,3,5,18,28,4.321428571428571
nintendo selects: super mario all-stars,0,1,4,3,20,28,4.5
ps3 memory card adaptor,2,0,8,1,17,28,4.107142857142857
call of duty 3 platinum hits -xbox 360,2,0,8,4,14,28,4.0
playstation 3 horizontal cooling power station,2,2,2,3,19,28,4.25
legacy of kain: soul reaver 2,0,0,8,2,18,28,4.357142857142857
odin sphere - playstation 2,1,4,3,9,11,28,3.892857142857143
crazy taxi,0,1,2,7,18,28,4.5
hatsune miku: project diva f 2nd - playstation vita,0,0,2,4,22,28,4.714285714285714
grand theft auto: liberty city stories - playstation 2,1,1,9,7,10,28,3.857142857142857
grand theft auto san andreas greatest hits - playstation 2,0,0,1,2,25,28,4.857142857142857
super mario bros.,1,0,0,4,23,28,4.714285714285714
[2 pack] slickblue soft flexible silicone gel rubber grip protective case cover for xbox-one game controller - blue [xbox one],1,3,2,8,14,28,4.107142857142857
wii fit trainer amiibo - japan import (super smash bros series),0,1,1,1,25,28,4.785714285714286
god of war collection - playstation vita,0,1,0,2,25,28,4.821428571428571
speed racer: the videogame - nintendo wii,0,0,2,14,12,28,4.357142857142857
spyro 2: ripto's rage,0,0,1,7,20,28,4.678571428571429
fight night round 3 - xbox 360,0,0,2,12,14,28,4.428571428571429
red steel - nintendo wii,4,2,4,12,6,28,3.5
naruto shippuden: ultimate ninja storm 4 - playstation 4,0,0,0,5,23,28,4.821428571428571
lego jurassic world - playstation 4 standard edition,0,0,1,5,22,28,4.75
castlevania: portrait of ruin,0,0,2,6,20,28,4.642857142857143
final fantasy tactics a2: grimoire of the rift,1,0,4,11,12,28,4.178571428571429
perfect dark zero: limited collector's edition,2,4,7,4,11,28,3.642857142857143
elite beat agents nds,0,2,3,5,18,28,4.392857142857143
wolfenstein: the old blood - playstation 4,1,0,2,9,16,28,4.392857142857143
need for speed: undercover - playstation 3,4,1,6,8,9,28,3.607142857142857
prince of persia warrior within - playstation 2,2,2,5,7,12,28,3.892857142857143
tom clancy's the division (gold edition) - playstation 4,3,1,3,6,15,28,4.035714285714286
street fighter v - collector's edition - playstation 4,2,3,4,2,17,28,4.035714285714286
dishonored definitive edition - playstation 4,0,1,2,10,15,28,4.392857142857143
halo wars - xbox 360 (platinum hits),1,1,2,6,18,28,4.392857142857143
stuntman,4,5,8,5,6,28,3.142857142857143
mass effect trilogy - pc,1,2,2,6,17,28,4.285714285714286
fallout: new vegas ultimate edition - pc,0,0,8,4,16,28,4.285714285714286
grand theft auto: vice city stories - playstation 2,1,3,3,7,14,28,4.071428571428571
madden nfl 10 - xbox 360,1,4,7,8,8,28,3.642857142857143
shadows of the damned - xbox 360,0,1,6,12,9,28,4.035714285714286
michael jackson the experience - nintendo wii,0,1,0,6,21,28,4.678571428571429
split/second - playstation 3,0,1,6,8,13,28,4.178571428571429
rayman origins - xbox 360,1,1,1,3,22,28,4.571428571428571
playstation vita usb cable,0,0,3,3,22,28,4.678571428571429
cta digital nintendo 3ds cartridge storage solution box,1,2,3,9,13,28,4.107142857142857
resident evil archives: resident evil,1,1,3,1,22,28,4.5
oddworld: munch's oddysee (xbox),1,3,1,11,12,28,4.071428571428571
"wall charger for nintendo ds lite (lifetime warranty, bulk packaging)",1,0,2,1,24,28,4.678571428571429
".hack, part 1: infection",2,1,5,9,11,28,3.9285714285714284
psp umd case,0,1,0,3,24,28,4.785714285714286
the 3rd birthday - sony psp,1,1,6,4,16,28,4.178571428571429
two worlds 2 - playstation 3,3,4,9,3,9,28,3.392857142857143
the sims 2 university expansion pack - pc,1,1,1,8,16,27,4.37037037037037
ps3 ear force px21 gaming headset,2,3,3,6,13,27,3.925925925925926
final fantasy xii: revenant wings - nintendo ds,1,3,3,11,9,27,3.888888888888889
doom 3 limited collector's edition - xbox (collector's),0,0,0,4,23,27,4.851851851851852
wii console with mario kart wii bundle - white,2,0,1,1,23,27,4.592592592592593
battlefield: 1942 - pc,1,1,1,7,17,27,4.407407407407407
rainbow six 3 (tom clancy's) - xbox,0,0,4,8,15,27,4.407407407407407
nba 2k14 - playstation 3,5,1,0,5,16,27,3.962962962962963
nyko power kit plus - 2 pack rechargeable battery and replacement cover with micro-usb charging cable for xbox one,1,0,4,2,20,27,4.481481481481482
xbox 360 wired controller,1,0,0,8,18,27,4.555555555555555
xbox 360 play & charge kit,2,4,1,4,16,27,4.037037037037037
nba 2k14 - xbox 360,4,1,2,8,12,27,3.8518518518518516
star wars: battlefront - standard edition - pc,4,3,5,10,5,27,3.3333333333333335
elder scrolls 3: morrowind - pc,1,3,6,5,12,27,3.888888888888889
the witcher 3: wild hunt - pc,1,1,3,2,20,27,4.444444444444445
sony psp-1001k playstation portable (psp) system (black),2,2,0,2,21,27,4.407407407407407
onimusha 3: demon siege,0,1,3,7,16,27,4.407407407407407
cooking mama 2: dinner with friends - nintendo ds,0,0,1,8,18,27,4.62962962962963
component av cable for nintendo wii to hdtv,1,1,0,4,21,27,4.592592592592593
titan quest gold (titan quest and titan quest immortal throne),0,1,4,6,16,27,4.37037037037037
xbox 360 500gb call of duty bundle,2,0,2,3,20,27,4.444444444444445
nyko power grip for ps vita (pch-2000),2,4,1,3,17,27,4.074074074074074
gears of war - pc,3,4,4,7,9,27,3.5555555555555554
world of warcraft 60 day pre-paid time card - pc/mac,1,0,0,2,24,27,4.777777777777778
star wars episode iii revenge of the sith - playstation 2,0,3,4,7,13,27,4.111111111111111
jsrf- jet set radio future,1,2,3,6,15,27,4.185185185185185
borderlands 2: game of the year edition,1,0,0,5,21,27,4.666666666666667
diablo iii: collector's edition,2,1,1,7,16,27,4.2592592592592595
fallout 3 collector's edition - pc,2,0,2,6,17,27,4.333333333333333
guild wars game of the year - pc,2,1,6,6,12,27,3.925925925925926
turok - playstation 3,2,1,8,7,9,27,3.740740740740741
the legend of zelda - the minish cap,0,1,1,3,22,27,4.703703703703703
nhl 15 - playstation 4,6,1,3,6,11,27,3.5555555555555554
just dance 2015 - wii,0,0,1,7,19,27,4.666666666666667
mirror's edge - pc,2,4,8,6,7,27,3.4444444444444446
the elder scrolls iv: oblivion - playstation 3 (greatest hits),2,0,2,4,19,27,4.407407407407407
syndicate,1,2,2,8,14,27,4.185185185185185
grand theft auto 3 - pc,4,0,4,6,13,27,3.888888888888889
xbox controller s-blue,1,0,1,4,21,27,4.62962962962963
nyko intercooler ex cooling fan for xbox 360,12,5,3,2,5,27,2.3703703703703702
two worlds - xbox 360,2,5,5,9,6,27,3.4444444444444446
danganronpa: trigger happy havoc - playstation vita,0,0,1,3,23,27,4.814814814814815
mayflash nintendo gamecube controller adapter for wii/wii u,2,1,3,7,14,27,4.111111111111111
fallout: new vegas,1,0,3,8,15,27,4.333333333333333
jinhezo sensor tv mount clip for xbox 360 kinect,3,0,1,4,19,27,4.333333333333333
half life 2 - xbox,0,0,2,7,18,27,4.592592592592593
"nintendo 3ds xl, silver - mario & luigi dream team limited edition",1,0,0,6,20,27,4.62962962962963
project x zone - nintendo 3ds,3,1,3,5,15,27,4.037037037037037
xbox 360 silver controller and play & charge kit,3,0,0,11,13,27,4.148148148148148
nintendo dsi xl - midnight blue,0,0,1,2,24,27,4.851851851851852
persona 5 - steelbook edition - playstation 4,0,0,0,2,25,27,4.925925925925926
pokémon mystery dungeon: gates to infinity - 3ds,0,1,3,7,16,27,4.407407407407407
half-life: game of the year edition - pc,1,0,2,6,18,27,4.481481481481482
4gb playstation vita memory card,3,5,4,4,11,27,3.5555555555555554
castlevania: the dracula x chronicles - sony psp,2,1,2,6,16,27,4.222222222222222
marvel ultimate alliance 2 - playstation 3,2,3,12,7,3,27,3.2222222222222223
dead or alive 4,1,1,3,4,18,27,4.37037037037037
star wars battlefront - xbox,0,0,3,9,15,27,4.444444444444445
burnout revenge - xbox 360,0,0,2,6,19,27,4.62962962962963
sony playstation memory card,2,0,2,3,20,27,4.444444444444445
the legend of zelda - classic nes series,1,1,1,6,18,27,4.444444444444445
wwe smackdown! shut your mouth,0,1,1,7,18,27,4.555555555555555
teenage mutant ninja turtles: mutants in manhattan - playstation 4,5,4,2,10,6,27,3.2962962962962963
driver san francisco - playstation 3,1,0,1,8,17,27,4.481481481481482
espn nfl 2k5 - playstation 2 (limited),0,1,2,5,19,27,4.555555555555555
nintendo nfc reader/writer accessory - nintendo 3ds,1,0,0,4,22,27,4.703703703703703
dissidia final fantasy - sony psp,0,2,1,5,19,27,4.518518518518518
steep - ps4 digital code,4,0,13,8,2,27,3.1481481481481484
bully: scholarship edition,0,0,0,8,19,27,4.703703703703703
bionic commando - xbox 360 (game),1,4,6,10,6,27,3.5925925925925926
xbox one 500gb console - gears of war: ultimate edition bundle,9,0,2,4,12,27,3.3703703703703702
virtua fighter 5 - playstation 3,3,3,4,5,12,27,3.740740740740741
the sims 3 island paradise - pc/mac,0,0,2,7,18,27,4.592592592592593
mass effect andromeda - pc,3,4,5,7,8,27,3.4814814814814814
kingdoms of amalur: reckoning - pc,0,3,6,9,9,27,3.888888888888889
dragon ball z: budokai,1,2,6,12,6,27,3.740740740740741
jeanne d'arc - sony psp,1,2,0,5,19,27,4.444444444444445
playstation portable limited edition daxter entertainment pack - ice silver,0,0,2,7,18,27,4.592592592592593
dungeon siege iii - playstation 3,3,1,5,6,11,26,3.8076923076923075
lego batman 3: beyond gotham - xbox 360,0,1,3,1,21,26,4.615384615384615
hori mario kart 8 racing wheel (luigi) - nintendo wii u,0,0,1,3,22,26,4.8076923076923075
final fantasy: the 4 heroes of light,0,1,3,8,14,26,4.346153846153846
the walking dead: the complete first season - playstation 4,0,2,2,1,21,26,4.576923076923077
need for speed underground 2 - playstation 2,1,1,3,6,15,26,4.269230769230769
wii fit rechargeable battery pack for balance board,2,2,0,8,14,26,4.153846153846154
fatal frame iii: the tormented - playstation 2,1,0,0,5,20,26,4.653846153846154
virtua fighter 4 - playstation 2,1,2,5,6,12,26,4.0
crash bandicoot 3: warped,0,0,2,3,21,26,4.730769230769231
kirby: planet robobot - nintendo 3ds standard edition,0,3,1,4,18,26,4.423076923076923
quake 4 - pc,5,2,3,8,8,26,3.4615384615384617
world of warcraft: mists of pandaria - pc/mac - (obsolete),3,4,8,1,10,26,3.423076923076923
wwe 2k17 - playstation 4,3,1,5,3,14,26,3.923076923076923
"pokemon, silver version",0,0,1,8,17,26,4.615384615384615
clubhouse games - nintendo ds,0,0,7,8,11,26,4.153846153846154
ps3 vertical stand for ps3 slim cech 2000 series only,1,1,2,4,18,26,4.423076923076923
star wars: rebel strike - rogue squadron iii,2,2,3,5,14,26,4.038461538461538
banjo-tooie,0,0,0,4,22,26,4.846153846153846
wwe smackdown vs. raw 2007 - playstation 2,2,3,4,6,11,26,3.8076923076923075
tom clancy's rainbow six vegas 2 - pc,0,4,2,10,10,26,4.0
deus ex - pc,0,0,1,1,24,26,4.884615384615385
sonic boom: rise of lyric - wii u,7,0,5,6,8,26,3.3076923076923075
rise of the tomb raider - xbox 360 - xbox 360 standard edition,1,0,1,4,20,26,4.615384615384615
star wars: shadows of the empire,1,2,0,10,13,26,4.230769230769231
bowser jr. amiibo - japan import (super smash bros series),0,0,0,3,23,26,4.884615384615385
harvest moon: animal parade - nintendo wii,0,0,1,6,19,26,4.6923076923076925
homefront [download],4,1,8,4,9,26,3.5
iron man - playstation 3,8,2,2,6,8,26,3.1538461538461537
playstation 4 500gb limited edition console - destiny: the taken king bundle [discontinued],0,2,2,2,20,26,4.538461538461538
mario modern color amiibo - japan import (super smash bros series),1,0,0,1,24,26,4.8076923076923075
metroid: zero mission,1,0,1,11,13,26,4.346153846153846
onimusha 2: samurai's destiny,1,0,2,9,14,26,4.346153846153846
elder scrolls iv oblivion - xbox 360,1,1,3,5,16,26,4.3076923076923075
playstation 4 500gb console - star wars battlefront bundle[discontinued],2,0,2,4,18,26,4.384615384615385
hori mario kart 8 racing wheel link for nintendo wii u and wii,0,0,1,3,22,26,4.8076923076923075
ninja gaiden dragon sword,0,2,1,6,17,26,4.461538461538462
nights of azure - playstation 4,2,3,6,5,10,26,3.6923076923076925
xbox 360 120gb hard drive,4,2,3,9,8,26,3.576923076923077
amiibo rosetta & chiko (rosalina & luna) - japanese import,0,0,0,2,24,26,4.923076923076923
ea sports ufc 2 - playstation 4,6,3,1,5,11,26,3.4615384615384617
dragon quest vii: fragments of the forgotten past - nintendo 3ds,0,0,3,2,21,26,4.6923076923076925
final fantasy: mystic quest,2,5,5,3,11,26,3.6153846153846154
half-life 2: episode pack - pc,4,2,2,2,16,26,3.923076923076923
guitar hero encore: rocks the 80's - playstation 2,0,4,8,7,7,26,3.6538461538461537
dino crisis,0,1,0,11,14,26,4.461538461538462
star fox assault,0,3,2,5,16,26,4.3076923076923075
capcom classics collection,0,0,4,5,17,26,4.5
pro evolution soccer 2012 - playstation 3,0,1,0,5,20,26,4.6923076923076925
6-feet rca av audio/video cable for playstation and playstation 2 - bulk packaging,0,0,0,5,21,26,4.8076923076923075
left 4 dead 2 - pc,1,1,5,4,15,26,4.1923076923076925
sonic & sega all-stars racing - nintendo wii,0,0,2,4,20,26,4.6923076923076925
ufc undisputed 3,0,0,2,6,18,26,4.615384615384615
star ocean: the last hope - xbox 360,2,1,6,6,11,26,3.8846153846153846
ufc - xbox one,4,5,5,6,6,26,3.1923076923076925
guitar hero iii: legends of rock - xbox 360,1,0,5,9,11,26,4.115384615384615
dungeon siege - pc,0,0,4,9,13,26,4.346153846153846
microsoft xbox 360 20gb,5,2,2,3,14,26,3.730769230769231
fight night round 3 - playstation 3,1,4,3,6,12,26,3.923076923076923
shadow hearts,0,0,2,7,17,26,4.576923076923077
sony computer entertainment playstation 3 12gb system,4,0,1,3,18,26,4.1923076923076925
the godfather ii - playstation 3,2,3,5,10,6,26,3.576923076923077
soul calibur ii - xbox (platinum),1,0,4,5,16,26,4.346153846153846
the darkness - playstation 3,2,0,4,3,17,26,4.269230769230769
call of duty 4: modern warfare game of the year edition - pc,2,1,2,5,16,26,4.230769230769231
watch dogs - pc,4,2,7,5,8,26,3.423076923076923
cryostasis - pc,2,6,6,7,5,26,3.269230769230769
turtle beach ear force p4c playstation 4 gaming chat communicator (discontinued by manufacturer),4,2,10,6,4,26,3.1538461538461537
kane and lynch 2: dog days - xbox 360,0,1,10,4,11,26,3.9615384615384617
driver 2 - playstation,0,3,5,1,17,26,4.230769230769231
"phoenix wright, ace attorney: justice for all - nintendo ds",0,0,2,6,18,26,4.615384615384615
tenchu: wrath of heaven,0,2,4,4,16,26,4.3076923076923075
nyko game case for vita - playstation vita,1,1,1,2,21,26,4.576923076923077
katamari forever - playstation 3,0,0,5,10,11,26,4.230769230769231
pokemon colosseum,0,3,1,8,14,26,4.269230769230769
army of two: the 40th day - xbox 360,1,2,6,9,8,26,3.8076923076923075
medal of honor: warfighter - pc,5,0,4,4,13,26,3.769230769230769
ninja gaiden 3 - xbox 360,4,1,5,5,11,26,3.6923076923076925
tom clancy's ghost recon advanced warfighter 2 - playstation 3,0,3,5,6,12,26,4.038461538461538
sonic advance,1,0,2,5,18,26,4.5
ninja gaiden sigma plus - playstation vita,1,0,1,7,17,26,4.5
playstation 3 500 gb system,0,1,0,2,23,26,4.8076923076923075
madden nfl 10 - playstation 3,1,1,6,7,11,26,4.0
diddy kong racing,1,1,1,6,16,25,4.4
wolfenstein - pc,3,2,2,6,12,25,3.88
silent hill hd collection - xbox 360,1,2,2,3,17,25,4.32
ike amiibo - japan import (super smash bros series),1,0,0,3,21,25,4.72
tony hawk's pro skater 5 - standard edition - playstation 4,15,0,1,2,7,25,2.44
the chronicles of riddick: escape from butcher bay - xbox,0,0,2,8,15,25,4.52
snk arcade classics vol 1 - playstation 2,0,0,2,13,10,25,4.32
sniper elite v2 - xbox 360,0,0,2,8,15,25,4.52
captain america: super soldier - playstation 3,1,0,5,8,11,25,4.12
mark of kri - playstation 2,1,1,4,6,13,25,4.16
mystery p.i.: the lottery ticket - pc,2,0,2,8,13,25,4.2
sly 2: band of thieves,0,0,2,2,21,25,4.76
sid meier's civilization iv,2,3,8,3,9,25,3.56
grand theft auto: episodes from liberty city,0,0,2,7,16,25,4.56
pokemon emerald version - game boy advance,0,0,3,7,15,25,4.48
rollercoaster tycoon 3 - pc,3,2,4,7,9,25,3.68
lego dimensions starter pack - nintendo wii u,1,1,1,4,18,25,4.48
madden nfl 08 - xbox 360,1,1,9,7,7,25,3.72
tales of legendia - playstation 2,1,3,6,3,12,25,3.88
walk it out - nintendo wii,2,1,2,3,17,25,4.28
mario golf: world tour - nintendo 3ds,1,0,2,8,14,25,4.36
x-men legends - playstation 2,0,1,2,10,12,25,4.32
playstation vita first edition bundle,0,1,2,6,16,25,4.48
super mario land,0,1,2,8,14,25,4.4
mega man zero collection - nintendo ds,0,0,1,3,21,25,4.8
zero escape: virtue's last reward - nintendo 3ds,0,0,2,3,20,25,4.72
my weight loss coach - nintendo ds,0,2,8,6,9,25,3.88
mech assault - xbox,0,0,5,7,13,25,4.32
legobatman2: dc super heroes - nintendo wii,0,0,2,10,13,25,4.44
red steel 2,0,1,1,11,12,25,4.36
crash bandicoot 2: cortex strikes back,1,0,0,8,16,25,4.52
lego pirates of the caribbean - xbox 360,0,0,2,6,17,25,4.6
shadow the hedgehog - gamecube,5,1,3,5,11,25,3.64
super mario bros. - classic nes series,2,2,0,1,20,25,4.4
bioshock ultimate rapture edition - xbox 360,0,0,0,4,21,25,4.84
my word coach - nintendo ds,1,3,2,10,9,25,3.92
overlord - xbox 360,1,1,2,13,8,25,4.04
big kahuna reef [download],2,0,4,7,12,25,4.08
microsoft xbox one controller + wireless adapter for windows 10,0,0,2,6,17,25,4.6
disney infinity 3.0 edition: star wars darth maul figure,0,0,0,0,25,25,5.0
rune factory: frontier - nintendo wii,1,1,2,5,16,25,4.36
tom clancy's splinter cell: conviction,8,1,2,3,11,25,3.32
xbox one limited edition halo 5: guardians master chief wireless controller,1,0,1,2,21,25,4.68
murdered: soul suspect x360,0,1,4,11,9,25,4.12
wii remote motionplus bundle - black,0,0,0,3,22,25,4.88
mystery p.i. portrait of a thief - nintendo ds,0,1,5,10,9,25,4.08
kingdom hearts hd 1.5 remix - limited edition - playstation 3,0,0,2,6,17,25,4.6
half-life 2: episode one,2,3,2,8,10,25,3.84
yakuza dead souls,0,2,2,9,12,25,4.24
spyro: enter the dragonfly,6,4,6,5,4,25,2.88
dynasty warriors 6 - playstation 3,2,4,2,4,13,25,3.88
planescape: torment - pc,1,0,3,3,18,25,4.48
socom 3 u.s. navy seals - playstation 2,0,0,3,7,15,25,4.48
titanfall - pc,3,2,4,4,12,25,3.8
medal of honor airborne - xbox 360,1,3,9,3,9,25,3.64
american mcgee's alice - pc,0,0,2,7,16,25,4.56
jet grind radio,0,0,3,6,16,25,4.52
empire: total war - pc,9,2,1,5,8,25,3.04
conception ii: children of the seven stars - playstation vita,1,3,5,4,12,25,3.92
kingdom hearts chain of memories,2,0,3,6,14,25,4.2
fifa 15 - playstation 3,0,0,1,2,22,25,4.84
beyond good & evil,0,0,2,5,18,25,4.64
final fantasy iii,0,0,3,0,22,25,4.76
viva piñata (platinum family hits),0,0,4,5,16,25,4.48
prince of persia: the sands of time,1,1,3,5,15,25,4.28
"tritton kama stereo headset for playstation 4, xbox one, nintendo switch",2,4,2,3,14,25,3.92
the sims 2: apartment life expansion pack,2,1,3,6,13,25,4.08
crysis 3 - pc,1,1,4,5,14,25,4.2
uncharted 3: drake's deception (collector's edition) - playstation 3,0,2,1,0,22,25,4.68
ps3 bluetooth headset,4,0,2,4,15,25,4.04
fighter within,2,2,2,8,11,25,3.96
madden nfl 15 - xbox 360,1,2,1,2,19,25,4.44
resident evil 5 - pc,1,1,2,5,16,25,4.36
playstation 4 dust cover by foamy lizard ® the original made in u.s.a. texoshield (tm) premium soft lining ps4 nylon dust guard cover [uspto patent pending] with back cable port (horizontal),0,0,3,1,21,25,4.72
sega genesis core system 2 - video game console,0,0,1,2,22,25,4.84
middle earth: shadow of mordor - xbox 360,2,2,5,8,8,25,3.72
silent hill hd collection - playstation 3,3,2,3,3,14,25,3.92
little big planet 3 launch edition - playstation 4,1,2,6,5,11,25,3.92
call of duty: black ops lto - playstation 3 (standard lto),0,4,0,3,18,25,4.4
villager amiibo - japan import (super smash bros series),0,1,1,1,22,25,4.76
hitman: codename 47,2,2,2,10,9,25,3.88
guitar hero iii: legends of rock wireless bundle,2,2,3,5,13,25,4.0
dishonored: game of the year edition,0,1,1,5,18,25,4.6
rocksmith 2014 edition - playstation 4,2,0,3,5,15,25,4.24
frontlines: fuel of war - xbox 360,1,1,6,8,9,25,3.92
nes remix pack,4,1,1,5,14,25,3.96
red dead redemption: undead nightmare pack - ps3 [digital code],1,2,3,6,13,25,4.12
sony computer entertainment psp-2000 av cable,2,2,1,5,15,25,4.16
xbox $5 gift card - xbox 360 digital code,0,0,1,2,22,25,4.84
resident evil 4 - pc,4,1,3,7,10,25,3.72
gamecube compatible 64mb memory card with 1019 blocks,0,0,1,2,21,24,4.833333333333333
age of mythology - pc,0,3,2,3,16,24,4.333333333333333
kingdom hearts hd 2.8 final chapter prologue - playstation 4,0,1,6,5,12,24,4.166666666666667
xbox 360 memory unit 512mb (original xbox 360 console only),1,0,2,7,14,24,4.375
the suffering,0,2,3,7,12,24,4.208333333333333
watch dogs - nintendo wii u,2,1,2,5,14,24,4.166666666666667
burnout 3 takedown - xbox,0,0,1,3,20,24,4.791666666666667
wwe 2k15 - playstation 3,3,3,4,2,12,24,3.7083333333333335
pandora's tower - nintendo wii,1,0,2,8,13,24,4.333333333333333
h.a.w.x. - pc dvd-rom,0,1,6,3,14,24,4.25
aion: the tower of eternity steelbook edition - pc,4,6,4,7,3,24,2.9583333333333335
new super mario bros. u + new super luigi u - wii u,0,0,1,2,21,24,4.833333333333333
kinect sensor with kinect adventures and gunstringer token code (old model),1,1,1,3,18,24,4.5
dragon age inquisition - standard edition - xbox 360,5,2,2,4,11,24,3.5833333333333335
medal of honor: pacific assault - pc,3,2,4,3,12,24,3.7916666666666665
command & conquer 4: tiberian twilight [download],16,4,0,1,3,24,1.7916666666666667
excite truck - nintendo wii,0,3,1,8,12,24,4.208333333333333
vampire: the masquerade - bloodlines,1,0,3,10,10,24,4.166666666666667
hunter: the reckoning,1,2,4,11,6,24,3.7916666666666665
mlb 12 the show - playstation vita,1,1,5,4,13,24,4.125
trauma center: under the knife 2,0,0,2,9,13,24,4.458333333333333
nintendo boo amiibo (sm series) - nintendo wii u,0,0,0,3,21,24,4.875
pdp psvita pull 'n go folio,0,1,0,4,19,24,4.708333333333333
wwe: smackdown! just bring it!,4,0,3,5,12,24,3.875
final fantasy xii: the zodiac age - playstation 4,1,0,1,2,20,24,4.666666666666667
zero escape: virtue's last reward - playstation vita,2,1,0,4,17,24,4.375
psp 2000 battery charger,2,0,0,4,18,24,4.5
pokemon gold,1,0,0,4,19,24,4.666666666666667
red faction ii,0,0,4,10,10,24,4.25
robert ludlum's the bourne conspiracy - xbox 360,2,3,6,8,5,24,3.4583333333333335
skylanders swap force: lightcore grim creeper character,0,0,0,2,22,24,4.916666666666667
7 days to die - playstation 4,6,1,7,4,6,24,3.125
disgaea: hour of darkness (greatest hits),0,0,3,9,12,24,4.375
middle earth: shadow of mordor - playstation 3,6,3,3,3,9,24,3.25
pokemon - red version,0,0,2,5,17,24,4.625
dark void - xbox 360,2,6,8,1,7,24,3.2083333333333335
mafia - pc,2,3,3,4,12,24,3.875
dragon quest v: hand of the heavenly bride - nintendo ds,0,0,2,3,19,24,4.708333333333333
splatterhouse - playstation 3,1,1,7,7,8,24,3.8333333333333335
mega man 3,0,0,1,1,22,24,4.875
time crisis: razing storm - playstation 3,1,1,2,6,14,24,4.291666666666667
the chronicles of riddick: assault on dark athena - playstation 3,0,4,3,7,10,24,3.9583333333333335
"medieval ii gold pack (total war, total war kingdoms) - pc",0,0,0,8,16,24,4.666666666666667
"alien: isolation - playstation 3, nostromo edition",3,2,4,3,12,24,3.7916666666666665
xbox 360 rock band special edition,1,0,1,9,13,24,4.375
final fantasy crystal chronicles: the crystal bearers,0,3,5,3,13,24,4.083333333333333
big brain academy,1,2,0,15,6,24,3.9583333333333335
turok: dinosaur hunter,0,1,2,2,19,24,4.625
jinhezo av cable for nintendo n64 / gamecube,0,1,3,4,16,24,4.458333333333333
dead to rights - xbox,6,3,6,5,4,24,2.9166666666666665
lego star wars ii: the original trilogy - playstation 2,0,0,0,5,19,24,4.791666666666667
star trek: conquest - playstation 2,0,2,3,6,13,24,4.25
untold legends:  dark kingdom - playstation 3,0,6,6,5,7,24,3.5416666666666665
shin megami tensei: persona 4 - playstation 2,1,0,1,2,20,24,4.666666666666667
star wars: the force unleashed - playstation 2,0,1,3,8,12,24,4.291666666666667
assassin's creed iv black flag - pc,3,0,2,2,17,24,4.25
star trek online - pc,3,6,9,5,1,24,2.7916666666666665
black - xbox,0,1,1,11,11,24,4.333333333333333
final fantasy:  crystal chronicles - gamecube,4,1,4,10,5,24,3.4583333333333335
"xbox 360 play and charge cable, white",0,2,2,6,14,24,4.333333333333333
"nintendo new 3ds xl battery charging dock (japanese version), black",0,0,3,8,13,24,4.416666666666667
wwf: no mercy,0,1,3,7,13,24,4.333333333333333
crimson skies: high road to revenge platinum hits - xbox,0,0,0,6,18,24,4.75
secret of mana,0,1,0,3,20,24,4.75
doom - pc,3,0,4,4,13,24,4.0
prototype - pc,3,1,4,10,6,24,3.625
xbox 360 20gb hard drive,1,3,8,3,9,24,3.6666666666666665
team fortress 2 - pc (collector's),4,2,4,0,14,24,3.75
super castlevania iv,0,0,0,2,22,24,4.916666666666667
unreal championship (xbox),0,3,7,5,9,24,3.8333333333333335
wwe smackdown vs. raw,2,2,6,4,10,24,3.75
battlefield: vietnam - pc,4,2,4,8,6,24,3.4166666666666665
fable: the lost chapters,1,0,7,8,8,24,3.9166666666666665
yoshi's new island - nintendo 3ds,0,0,3,1,20,24,4.708333333333333
final fantasy xv - xbox one,3,1,6,3,11,24,3.75
lego indiana jones: the original adventures,0,0,0,4,20,24,4.833333333333333
the legend of legacy - nintendo 3ds,0,2,6,3,13,24,4.125
kirby 64: the crystal shards,1,0,0,5,18,24,4.625
world of final fantasy - playstation vita,1,1,1,7,14,24,4.333333333333333
assassin's creed limited edition -xbox 360,0,0,4,0,20,24,4.666666666666667
primal - playstation 2,1,2,6,3,12,24,3.9583333333333335
legendary - playstation 3,6,4,3,4,7,24,3.0833333333333335
warioware: smooth moves,0,0,3,9,12,24,4.375
game boy micro black - game boy advance,4,2,4,1,13,24,3.7083333333333335
justice league heroes - playstation 2,1,0,2,8,13,24,4.333333333333333
james bond 007 agent under fire - playstation 2,1,1,6,6,10,24,3.9583333333333335
namco museum - nintendo ds,1,0,1,6,16,24,4.5
the sims 2 - playstation 2,2,0,3,9,10,24,4.041666666666667
the lego movie videogame - playstation 3,1,0,3,3,17,24,4.458333333333333
batman: arkham origins blackgate - nintendo 3ds,0,1,4,5,14,24,4.333333333333333
pokemon: yellow version - special pikachu edition,0,0,1,7,16,24,4.625
the warriors - playstation 2,0,1,3,5,15,24,4.416666666666667
syndicate - playstation 3,0,1,7,4,12,24,4.125
gears of war (2-disc edition) -xbox 360,0,1,1,6,16,24,4.541666666666667
lord of the rings: return of the king - playstation 2,0,4,1,11,8,24,3.9583333333333335
godfather - playstation 2,1,2,4,3,13,23,4.086956521739131
nintendogs dachshund & friends,1,0,1,7,14,23,4.434782608695652
final fantasy ii - sony psp,0,1,5,1,16,23,4.391304347826087
final fantasy iv,0,0,0,8,15,23,4.6521739130434785
hotel dusk: room 215,1,1,4,7,10,23,4.043478260869565
indigo prophecy - playstation 2,1,1,3,8,10,23,4.086956521739131
xbox 360 head set communicator,3,0,5,5,10,23,3.8260869565217392
sega genesis collection - playstation 2,0,0,0,4,19,23,4.826086956521739
blacksite: area 51 - xbox 360 (special),3,5,6,2,7,23,3.217391304347826
ps3 optical digital cable,0,0,0,2,21,23,4.913043478260869
pokemon pearl version nintendo ds,0,0,2,10,11,23,4.391304347826087
ace combat 5: the unsung war,0,3,5,5,10,23,3.9565217391304346
castlevania: curse of darkness,0,2,9,4,8,23,3.782608695652174
true crime: new york city - playstation 2,4,2,4,4,9,23,3.5217391304347827
nes controller - generic brand,1,2,1,2,17,23,4.391304347826087
x-men legends ii rise of apocalypse,1,2,3,11,6,23,3.8260869565217392
pinball hall of fame: the williams collection - nintendo wii,2,0,0,6,15,23,4.391304347826087
trenro dual playstation/playstation 2 to pc usb controller adapter,2,1,2,2,16,23,4.260869565217392
burnout legends - sony psp,0,0,0,7,16,23,4.695652173913044
warhawk bundle with bluetooth headset - playstation 3,0,1,3,4,15,23,4.434782608695652
rollercoaster tycoon 2: triple thrill pack - pc,0,1,4,2,16,23,4.434782608695652
twisted metal: head-on,2,1,0,4,16,23,4.3478260869565215
brothers in arms: hell's highway,0,1,1,6,15,23,4.521739130434782
castlevania ii: simon's quest,0,3,4,3,13,23,4.130434782608695
mortal kombat: shaolin monks - playstation 2,0,2,3,7,11,23,4.173913043478261
assassin's creed: brotherhood [download],0,0,2,9,12,23,4.434782608695652
deadmund's quest move bundle - playstation 3,0,0,0,2,21,23,4.913043478260869
rhythm heaven - nintendo ds,1,1,4,4,13,23,4.173913043478261
james bond 007 nightfire - gamecube,0,0,3,9,11,23,4.3478260869565215
xbox 360 e 250gb holiday value bundle [xbox 360],1,0,1,5,16,23,4.521739130434782
dishonored 2 - xbox one,2,1,2,6,12,23,4.086956521739131
playstation vita starter kit with memory card,1,1,6,3,12,23,4.043478260869565
ncaa football 13 - xbox 360,5,1,5,5,7,23,3.347826086956522
skylanders spyro's adventure pack - empire of ice,0,0,2,3,18,23,4.695652173913044
tokyo mirage sessions #fe - wii u standard edition,3,0,3,5,12,23,4.0
plants vs zombies garden warfare(online play required) - playstation 3,1,1,1,7,13,23,4.304347826086956
turtle beach ear force xp400 dolby surround sound gaming headset,3,1,2,4,13,23,4.0
"nyko modular charge station (new version) dual port controller charging station with patented charging dongles for all ps4 , ps4 slim and ps4 pro",0,0,0,2,21,23,4.913043478260869
illumishield – game nintendo 2ds screen protector japanese ultra clear hd film with anti-bubble and anti-fingerprint – high quality (invisible) lcd shield – lifetime replacement warranty – [3-pack] oem / retail packaging,0,0,1,4,18,23,4.739130434782608
hori battle pad for wii u (mario version) with turbo - nintendo wii u,1,1,1,5,15,23,4.391304347826087
fallout 4 - pip-boy edition - playstation 4,1,1,3,1,17,23,4.391304347826087
donkey kong country 3: dixie kong's double trouble - nintendo super nes,0,1,1,2,19,23,4.695652173913044
"skylanders swap force triple character pack: lava barf eruptor, slobber tooth, super gulp pop fizz",0,0,1,2,20,23,4.826086956521739
minecraft: wii u edition - wii u standard edition,0,2,2,2,17,23,4.478260869565218
professor layton and the unwound future - nintendo ds,0,0,4,4,15,23,4.478260869565218
marvel vs. capcom 2,0,0,2,3,18,23,4.695652173913044
transformers: fall of cybertron - playstation 3,0,2,2,6,13,23,4.304347826086956
marvel vs. capcom 2,0,1,1,5,16,23,4.565217391304348
deus ex: mankind divided - xbox one,0,3,4,4,12,23,4.086956521739131
silent hill 2: restless dreams,3,3,1,5,11,23,3.782608695652174
army of two the devil's cartel - xbox 360,1,1,3,5,13,23,4.217391304347826
playstation 3d display,7,2,2,3,9,23,3.217391304347826
dark cloud 2 - playstation 2,0,1,3,3,16,23,4.478260869565218
maximo ghosts to glory - playstation 2,1,1,5,7,9,23,3.9565217391304346
disney universe - playstation 3,0,1,1,4,17,23,4.608695652173913
nintendo 3ds xl gold/black - limited edition bundle with the legend of zelda: a link between worlds,2,0,2,2,17,23,4.391304347826087
yakuza 3 - playstation 3,0,0,3,4,16,23,4.565217391304348
tom nook amiibo (animal crossing series),0,0,0,1,22,23,4.956521739130435
lost planet 2 - xbox 360,1,2,4,3,13,23,4.086956521739131
unreal 2: the awakening,0,5,10,6,2,23,3.217391304347826
mass effect trilogy - xbox 360,2,0,3,5,13,23,4.173913043478261
arcania - the complete tale - playstation 4 standard edition,1,0,5,5,12,23,4.173913043478261
endless ocean: blue world - nintendo wii,0,1,3,6,13,23,4.3478260869565215
enter the matrix - xbox,0,5,5,4,9,23,3.739130434782609
xbox 360 wireless speed wheel,0,3,2,6,12,23,4.173913043478261
blur - xbox 360,1,2,4,5,11,23,4.0
battleborn - xbox one,2,5,3,4,9,23,3.5652173913043477
world of warcraft: warlords of draenor expansion - pc/mac,2,3,4,1,13,23,3.869565217391304
the witcher: wild hunt (comic bundle) - playstation 4,0,0,0,5,18,23,4.782608695652174
the order: 1886 collector's edition,1,0,3,5,14,23,4.3478260869565215
ssx 3 - playstation 2 (classics),0,0,3,3,17,23,4.608695652173913
fight night round 4 - xbox 360,4,2,5,5,7,23,3.391304347826087
microsoft kinect sports rivals xbox one english us / 5tw-00001,2,2,8,2,9,23,3.608695652173913
uncharted 4: a thief's end special edition - playstation 4,0,1,0,3,19,23,4.739130434782608
playstation 3 frontman wireless guitar - black,2,0,6,8,7,23,3.782608695652174
tna impact! - xbox 360,8,0,5,6,4,23,2.9130434782608696
murdered soul suspect,2,1,2,2,16,23,4.260869565217392
kings bounty: the legend - pc,2,0,4,11,6,23,3.8260869565217392
pdp energizer 2x controller charging station for ps4,1,2,0,5,15,23,4.3478260869565215
wrc 5 - playstation 3 - playstation 3,3,1,5,2,12,23,3.8260869565217392
super monkey ball 2,1,0,2,2,18,23,4.565217391304348
final fantasy,2,0,2,2,17,23,4.391304347826087
alone in the dark - pc,9,4,8,1,1,23,2.1739130434782608
yoshi's story,0,1,3,5,14,23,4.391304347826087
final fantasy crystal chronicles: ring of fates - nintendo ds,0,0,4,12,7,23,4.130434782608695
steep - xbox one,0,0,2,15,6,23,4.173913043478261
socom: us navy seals,0,0,3,6,14,23,4.478260869565218
dragon ball z: extreme butoden - nintendo 3ds,1,3,4,3,12,23,3.9565217391304346
golden axe: beast rider - playstation 3,0,6,5,3,9,23,3.652173913043478
harvest moon: island of happiness,1,2,2,6,12,23,4.130434782608695
dragonball z: burst limit - xbox 360,4,2,5,4,8,23,3.4347826086956523
super street fighter iv - xbox 360,1,0,1,4,17,23,4.565217391304348
advance wars,0,0,0,4,19,23,4.826086956521739
secret agent clank,0,2,4,2,15,23,4.304347826086956
disney infinity sorcerer's apprentice mickey,0,1,1,3,18,23,4.6521739130434785
tearaway unfolded - playstation 4,0,0,0,5,18,23,4.782608695652174
resident evil: revelations - xbox 360,0,0,3,6,14,23,4.478260869565218
50 cent: blood on the sand,0,2,5,10,6,23,3.869565217391304
afterglow universal wireless headset - blue,2,1,3,3,14,23,4.130434782608695
red faction armageddon - playstation 3,1,2,4,3,13,23,4.086956521739131
disney infinity figure violet,1,1,0,5,16,23,4.478260869565218
rock band 3 - xbox 360 (game),1,2,5,3,12,23,4.0
white knight chronicles ii,0,3,4,3,13,23,4.130434782608695
the lego movie videogame - xbox 360 standard edition,0,1,2,4,16,23,4.521739130434782
"pdp talon media remote control for xbox one, tv, blu-ray & streaming media",0,0,1,10,12,23,4.478260869565218
vagrant story,1,3,3,3,13,23,4.043478260869565
star wars jedi knight: jedi academy - pc,0,1,1,10,11,23,4.3478260869565215
need for speed most wanted - sony psp,1,0,2,9,10,22,4.2272727272727275
halo 4 limited edition -xbox 360,2,1,3,1,15,22,4.181818181818182
little deviants - playstation vita,0,1,4,5,12,22,4.2727272727272725
fifa soccer 12 - xbox 360,0,1,2,5,14,22,4.454545454545454
gamecube 251 memory card,0,0,0,3,19,22,4.863636363636363
mega man x,1,0,1,3,17,22,4.590909090909091
generic ac power adapter charger for nintendo 3ds/dsi/xl,3,0,1,1,17,22,4.318181818181818
ace combat 6: fires of liberation (platinum hits),0,2,1,9,10,22,4.2272727272727275
"gamecube wavebird wireless controller grey, silver, compatible with wii",0,0,1,2,19,22,4.818181818181818
bejeweled 3 - nintendo ds,0,0,0,1,21,22,4.954545454545454
uncharted 4: a thief's end libertalia collector's edition - playstation 4,0,0,0,1,21,22,4.954545454545454
bodycount - xbox 360,3,3,2,6,8,22,3.590909090909091
star wars episode iii revenge of the sith - xbox,0,1,3,7,11,22,4.2727272727272725
midway arcade origins - xbox 360,0,0,4,6,12,22,4.363636363636363
"action replay for nintendo 3ds, dsi, ds lite and ds - dsi yellow",0,1,3,5,13,22,4.363636363636363
nyko uboost - 2x power for up to 10 hours playtime for wii u gamepad,3,3,0,4,12,22,3.8636363636363638
ps3 - charge base,0,0,0,4,18,22,4.818181818181818
resident evil: outbreak file # 2 - playstation 2,0,1,6,3,12,22,4.181818181818182
need for speed: carbon - playstation 3,1,0,5,7,9,22,4.045454545454546
crazy taxi,1,2,6,6,7,22,3.727272727272727
jade empire - xbox,1,2,2,4,13,22,4.181818181818182
the sims 2 pets expansion pack - pc,0,0,5,8,9,22,4.181818181818182
the legend of zelda: oracle of ages,0,0,1,3,18,22,4.7727272727272725
the legend of zelda: oracle of seasons,1,0,0,3,18,22,4.681818181818182
middle earth: shadow of mordor game of the year - xbox one,1,0,1,2,18,22,4.636363636363637
sonic adventure 2,0,2,1,5,14,22,4.409090909090909
call of duty: black ops ii (revolution map pack included) - xbox 360,1,1,0,3,17,22,4.545454545454546
myst 3: exile - pc/mac,2,0,2,6,12,22,4.181818181818182
skylanders swap force tower of time adventure pack,0,0,0,1,21,22,4.954545454545454
powera universal nintendo 3ds the legend of zelda hylian shield case,0,2,1,2,17,22,4.545454545454546
mario party 7,0,1,1,4,16,22,4.590909090909091
turok - xbox 360,2,4,6,2,8,22,3.4545454545454546
mighty no. 9 - wii u,3,2,6,6,5,22,3.3636363636363638
world of warcraft: mists of pandaria - collector's edition,1,3,2,0,16,22,4.2272727272727275
animal crossing series 1 single pack of 6 cards,0,0,3,3,16,22,4.590909090909091
wwe '12,2,3,4,10,3,22,3.409090909090909
mario party 10 + mario amiibo bundle - wii u,3,0,2,4,13,22,4.090909090909091
mcbazel playstation 2 controller to usb adapter for pc or playstation 3 converter cable for sony dualshock ps2 ps3 controllers (not compatible with dancing mat guitar hero),2,2,3,2,13,22,4.0
defiance - xbox 360,5,2,3,4,8,22,3.3636363636363638
star trek: legacy - xbox 360,3,1,6,6,6,22,3.5
legacy of kain: soul reaver,2,1,0,2,17,22,4.409090909090909
mario tennis,0,0,0,4,18,22,4.818181818181818
dark messiah of might & magic elements - xbox 360,1,1,4,7,9,22,4.0
mortal kombat,0,5,5,3,9,22,3.727272727272727
south park:  the stick of truth - pc,1,1,0,9,11,22,4.2727272727272725
final fantasy vi,0,1,1,2,18,22,4.681818181818182
marvel ultimate alliance - playstation 2,1,0,0,2,19,22,4.7272727272727275
assassin's creed - ezio trilogy edition xbox 360,0,1,0,3,18,22,4.7272727272727275
halo 4: game of the year edition,0,1,1,6,14,22,4.5
time splitters ps2,2,2,1,2,15,22,4.181818181818182
nintendo 64 controller - original grey,1,1,3,6,11,22,4.136363636363637
mortal kombat ii,0,0,1,3,18,22,4.7727272727272725
fight night round 4 - playstation 3,2,1,3,5,11,22,4.0
devil may cry 3: dante's awakening - playstation 2 (special),0,2,1,6,13,22,4.363636363636363
pdp new nintendo 3ds xl clip armor - mario,3,0,3,3,13,22,4.045454545454546
hori battle pad for wii u (luigi version) with turbo - nintendo wii u,0,0,0,5,17,22,4.7727272727272725
project gotham racing 4 - xbox 360,1,2,2,7,10,22,4.045454545454546
"pikmin, new play control - nintendo wii",0,0,2,8,12,22,4.454545454545454
frontlines: fuel of war - pc,4,2,4,5,7,22,3.409090909090909
generic headset with microphone - xbox 360,1,2,0,11,8,22,4.045454545454546
socom ii u.s. navy seals - playstation 2,1,0,5,3,13,22,4.2272727272727275
the saboteur - pc,1,1,2,7,11,22,4.181818181818182
rollercoaster tycoon 2 - pc,2,2,3,4,11,22,3.909090909090909
final fantasy ii,1,0,2,2,17,22,4.545454545454546
terminator: salvation - playstation 3,2,4,7,3,6,22,3.3181818181818183
rover amiibo - nintendo wii u,0,0,0,4,18,22,4.818181818181818
lords of the fallen - playstation 4 : limited edition,4,3,2,4,9,22,3.5
street fighter alpha anthology - playstation 2,0,0,1,7,14,22,4.590909090909091
star fox,1,1,3,1,16,22,4.363636363636363
ctr: crash team racing,0,0,0,5,17,22,4.7727272727272725
buzz! quiz tv - playstation 3,0,0,2,10,10,22,4.363636363636363
pokemon snap,2,0,3,7,10,22,4.045454545454546
forza horizon 3 - ultimate edition - xbox one,0,0,2,1,19,22,4.7727272727272725
star wars republic commando - xbox,1,0,0,9,12,22,4.409090909090909
command & conquer 3: kane's wrath - xbox 360,0,2,4,4,12,22,4.181818181818182
star wars: the force unleashed - sony psp,0,2,4,6,10,22,4.090909090909091
major league baseball 2k8 - xbox 360,4,4,4,6,4,22,3.090909090909091
wii kama wireless controller (colours may vary),2,2,2,4,12,22,4.0
driv3r - playstation 2,3,3,2,4,10,22,3.6818181818181817
nintendo n64 console w/ one controller,0,0,0,2,20,22,4.909090909090909
kung fu panda - xbox 360,0,0,4,4,14,22,4.454545454545454
the elder scrolls iv: oblivion game of the year edition - pc,0,1,3,4,14,22,4.409090909090909
mayflash ps2 ps3 pc usb universal arcade fighting stick,2,2,10,2,6,22,3.3636363636363638
antec x-1 cooler for xbox one,2,2,6,7,5,22,3.5
onimusha: dawn of dreams,3,2,2,3,12,22,3.8636363636363638
deadly creatures - nintendo wii,0,2,6,5,9,22,3.9545454545454546
max payne 2: the fall of max payne - playstation 2,0,4,2,9,7,22,3.8636363636363638
grid - pc,4,2,0,6,10,22,3.727272727272727
gran turismo sport - limited edition - playstation 4,7,1,1,3,10,22,3.3636363636363638
painkiller - pc,2,2,3,9,6,22,3.6818181818181817
"turtle beach - ear force stealth 500p premium fully wireless gaming headset - dts headphone:x 7.1 surround sound - ps4, ps3, and mobile devices (discontinued by manufacturer)",2,2,4,6,8,22,3.727272727272727
freedom fighters the battle for liberty island - playstation 2,0,0,4,9,9,22,4.2272727272727275
professor layton vs phoenix wright ace attorney,0,1,1,5,15,22,4.545454545454546
fire emblem fates - special edition - nintendo 3ds,5,0,1,2,14,22,3.909090909090909
resident evil: survivor,4,4,2,4,8,22,3.3636363636363638
dragon age inquisition - standard edition - pc,3,1,3,2,13,22,3.9545454545454546
the witcher - pc,1,3,5,5,8,22,3.727272727272727
turtle beach - ear force playstation 4 upgrade kit for turtle beach headset compatibility - ps4 (discontinued by manufacturer),1,0,0,5,16,22,4.590909090909091
suikoden 3,1,3,1,7,10,22,4.0
the lord of the rings: the third age,3,1,4,8,6,22,3.590909090909091
battlefield hardline - pc,3,4,3,2,10,22,3.5454545454545454
advance wars: dual strike - nintendo ds,0,0,0,2,20,22,4.909090909090909
shin megami tensei: persona 3 portable - sony psp,1,1,1,1,18,22,4.545454545454546
disney infinity 3.0 edition: star wars the force awakens play set,0,0,1,4,17,22,4.7272727272727275
ufc undisputed 2010 - playstation 3,2,1,2,1,16,22,4.2727272727272725
dreamgear comfort grip protection for your new nintendo 3ds xl,1,2,2,3,14,22,4.2272727272727275
lego star wars: the complete saga - nintendo ds,0,1,2,5,14,22,4.454545454545454
guilty gear xrd -revelator- playstation 4,1,2,1,1,17,22,4.409090909090909
conan - xbox 360 (limited),3,2,6,6,5,22,3.3636363636363638
shadow warrior - xbox one,0,2,3,6,11,22,4.181818181818182
risen - xbox 360,2,4,1,10,5,22,3.5454545454545454
madden nfl 07 - xbox 360,5,8,3,2,4,22,2.6363636363636362
hasbro family fun pack - xbox one standard edition,1,0,3,9,9,22,4.136363636363637
rayman raving rabbids 2 - nintendo wii,0,0,5,8,9,22,4.181818181818182
dragon ball: raging blast 2 - playstation 3,1,2,4,0,15,22,4.181818181818182
breath of fire: dragon quarter - playstation 2,5,1,4,4,8,22,3.409090909090909
secret of evermore,0,0,3,2,16,21,4.619047619047619
disney infinity rapunzel,0,0,0,1,20,21,4.9523809523809526
metroid ii,0,1,2,4,14,21,4.476190476190476
hatsune miku: project mirai dx - nintendo 3ds,0,0,2,4,15,21,4.619047619047619
kameo: elements of power (platinum hits),1,1,5,5,9,21,3.9523809523809526
metal gear solid 3 subsistence,1,0,0,1,19,21,4.761904761904762
assassin's creed unity - pc,5,4,2,4,6,21,3.0952380952380953
untold legends: brotherhood of the blade - sony psp,0,2,2,2,15,21,4.428571428571429
lucario amiibo - japan import (super smash bros series),1,0,0,2,18,21,4.714285714285714
teenage mutant ninja turtles - nintendo 3ds,2,2,1,3,13,21,4.095238095238095
killer instinct,0,0,4,4,13,21,4.428571428571429
watch dogs limited edition - playstation 4,1,0,4,2,14,21,4.333333333333333
ultra street fighter iv - playstation 3,1,1,0,3,16,21,4.523809523809524
guitar hero (bundle with guitar),0,1,0,6,14,21,4.571428571428571
castlevania iii: dracula's curse,0,0,1,5,15,21,4.666666666666667
story of seasons - nintendo 3ds,0,1,0,4,16,21,4.666666666666667
parasite eve ii,2,0,3,4,12,21,4.142857142857143
sniper elite iii ultimate edition - playstation 4,1,0,4,5,11,21,4.190476190476191
"nyko charge base - playstation 4 with a modern and simple drop and charge design, dual patented dongle charging port, includes a usb and wall mount for super fast charging of ps4, ps4 pro and ps4 slim controllers",2,0,2,5,12,21,4.190476190476191
company of heroes - pc,0,1,3,3,14,21,4.428571428571429
xbox one special edition sunset overdrive bundle,3,0,1,2,15,21,4.238095238095238
star trek encounters - playstation 2,0,3,11,1,6,21,3.4761904761904763
devil's third - wii u standard edition,1,0,3,8,9,21,4.142857142857143
sniper elite iii - playstation 3 standard edition,1,2,1,2,15,21,4.333333333333333
saints row iv: re-elected + gat out of hell,3,4,1,3,10,21,3.619047619047619
spider-man,0,0,0,6,15,21,4.714285714285714
jade empire (limited edition),0,2,2,4,13,21,4.333333333333333
nintendo selects: the legend of zelda: the wind waker hd - wii u,0,0,0,2,19,21,4.904761904761905
final fantasy x/x-2 hd remaster limited edition - playstation 4,3,0,1,5,12,21,4.095238095238095
just dance 2015 - playstation 4,2,0,1,3,15,21,4.380952380952381
turtle beach ear force px4 wireless dolby 5.1 surround sound playstation 4 gaming headset,2,2,4,8,5,21,3.5714285714285716
xbox 360 4gb system console with peggle 2 bundle,0,2,0,0,19,21,4.714285714285714
super smash bros. bundle (wii u not included),2,0,1,1,17,21,4.476190476190476
lego batman 3: beyond gotham - wii u,0,0,2,3,16,21,4.666666666666667
the lego movie videogame - xbox one,1,0,1,6,13,21,4.428571428571429
grand theft auto vice city stories - sony psp,1,0,2,3,15,21,4.476190476190476
wwe 2k15 - xbox 360,4,0,2,6,9,21,3.761904761904762
nba 2k15 - playstation 3,1,1,2,1,16,21,4.428571428571429
sonic amiibo - japan import (super smash bros series),1,0,0,1,19,21,4.761904761904762
wave race 64,1,0,5,3,12,21,4.190476190476191
just dance 2014 - nintendo wii u,0,0,2,10,9,21,4.333333333333333
james bond 007: nightfire - playstation 2,2,0,4,7,8,21,3.9047619047619047
soul calibur v,2,3,6,3,7,21,3.4761904761904763
brute force,1,0,2,7,11,21,4.285714285714286
disgaea 3 absence of justice - playstation 3,0,0,3,6,12,21,4.428571428571429
game boy advance sp replacement battery pack for gba sp,0,0,3,1,17,21,4.666666666666667
medal of honor rising sun - playstation 2,2,3,5,6,5,21,3.4285714285714284
art academy - nintendo ds,0,1,5,7,8,21,4.0476190476190474
the sims 3: late night - pc/mac,1,0,0,5,15,21,4.571428571428571
s.t.a.l.k.e.r.: clear sky - pc,3,1,3,6,8,21,3.7142857142857144
phoenix wright ace attorney: trials and tribulations - nintendo ds,0,1,0,4,16,21,4.666666666666667
green lantern: rise of the manhunters - xbox 360,1,3,3,6,8,21,3.8095238095238093
james bond 007: everything or nothing - playstation 2,1,0,2,7,11,21,4.285714285714286
catherine - xbox 360,2,0,1,8,10,21,4.142857142857143
trauma center:  under the knife - nintendo ds,0,1,4,7,9,21,4.142857142857143
zack & wiki quest for barbaros’ treasure - nintendo wii,0,0,3,6,12,21,4.428571428571429
star wars bounty hunter - playstation 2,1,1,1,9,9,21,4.142857142857143
the sims 3 - xbox 360,1,3,5,4,8,21,3.7142857142857144
blathers amiibo (animal crossing series),0,0,0,4,17,21,4.809523809523809
no one lives forever 2: a spy in h.a.r.m.'s way,0,0,0,10,11,21,4.523809523809524
mlb the show 16 - playstation 4,1,1,0,3,16,21,4.523809523809524
ninja blade - xbox 360,1,2,3,6,9,21,3.9523809523809526
star ocean: first departure - sony psp,1,2,2,5,11,21,4.095238095238095
crysis maximum edition,5,0,1,8,7,21,3.5714285714285716
"hori compact playstand - zelda edition, officially licensed by nintendo - nintendo switch",0,0,2,2,17,21,4.714285714285714
donkey kong country,0,1,2,5,13,21,4.428571428571429
golden sun: the lost age,1,0,0,4,16,21,4.619047619047619
resident evil code veronica,0,1,1,5,14,21,4.523809523809524
guitar hero iii: legends of rock wireless bundle - xbox 360,0,1,3,8,9,21,4.190476190476191
lego star wars iii the clone wars - playstation 3,0,0,4,3,14,21,4.476190476190476
evil dead: a fistful of boomstick,0,0,5,5,11,21,4.285714285714286
generic remote + nunchuk nunchuck controller combo set bundle for nintendo wii,0,0,2,4,15,21,4.619047619047619
meta knight amiibo - nintendo 3ds,0,0,0,1,20,21,4.9523809523809526
metal gear solid 2:substance,0,1,2,3,15,21,4.523809523809524
odin sphere leifthrasir: storybook edition - playstation 4 storybook edition,0,1,0,2,18,21,4.761904761904762
the sims 3: world adventures expansion pack,4,0,3,5,9,21,3.7142857142857144
need for speed: underground 2 - xbox,1,1,1,7,11,21,4.238095238095238
the thing,1,4,4,3,9,21,3.7142857142857144
unreal tournament 2003 - pc,1,1,2,5,12,21,4.238095238095238
the last remnant -xbox 360,3,2,3,6,7,21,3.5714285714285716
nba street volume 2 - playstation 2,1,0,1,5,14,21,4.476190476190476
mystery case files: madame fate - pc,0,0,0,4,17,21,4.809523809523809
world heroes anthology - playstation 2,0,0,6,4,11,21,4.238095238095238
xbox one 1tb console - halo: the master chief collection bundle,3,1,2,3,12,21,3.9523809523809526
"twisted metal: head on, extra twisted edition",0,0,0,14,7,21,4.333333333333333
hde charging cable for ps3 controllers usb charging cord compatible with wireless dualshock 3 controllers,0,1,0,0,20,21,4.857142857142857
mega man anniversary collection - gamecube,0,0,1,8,12,21,4.523809523809524
red dead revolver - xbox,1,0,5,7,8,21,4.0
mike tyson's punch-out!! - nintendo nes,0,0,0,2,19,21,4.904761904761905
guitar hero aerosmith - nintendo wii (game only),2,2,6,10,1,21,3.2857142857142856
naruto: ultimate ninja 3 - playstation 2,0,2,4,4,11,21,4.142857142857143
zone of the enders,1,0,3,10,7,21,4.0476190476190474
bullet witch - xbox 360,1,7,4,4,5,21,3.238095238095238
grand theft auto v (special edition) - playstation 3,1,1,3,4,12,21,4.190476190476191
sonic lost world 3ds,0,2,3,6,10,21,4.142857142857143
xbox one special edition covert forces wireless controller,3,1,0,0,17,21,4.285714285714286
need for speed - xbox one,10,2,2,2,5,21,2.5238095238095237
the sims: hot date expansion pack - pc,0,1,4,4,12,21,4.285714285714286
wwe smackdown vs raw 2006 - playstation 2,1,1,1,4,14,21,4.380952380952381
medieval moves: deadmund's quest - playstation 3,0,0,2,4,15,21,4.619047619047619
brothers in arms: road to hill 30 - pc,2,3,4,5,7,21,3.5714285714285716
kinect sports season two,0,0,4,5,12,21,4.380952380952381
baten kaitos,0,0,1,9,11,21,4.476190476190476
skylanders superchargers: racing sea pack,0,0,1,1,19,21,4.857142857142857
tenchu z - xbox 360,1,2,4,4,10,21,3.9523809523809526
batman: return to arkham - playstation 4 standard edition,0,0,1,5,15,21,4.666666666666667
harvest moon: a wonderful life,1,0,3,7,10,21,4.190476190476191
xbox one 1tb console - forza motorsport 6 bundle,3,0,1,3,14,21,4.190476190476191
assassin's creed i & ii,1,1,3,4,12,21,4.190476190476191
the amazing spider-man,0,2,3,5,11,21,4.190476190476191
mortal kombat trilogy,2,1,3,4,11,21,4.0
horizon zero dawn - playstation 4 collector's edition,0,0,0,2,19,21,4.904761904761905
plants vs. zombies garden warfare 2 - playstation 4,1,0,4,4,12,21,4.238095238095238
tera online,0,1,4,5,11,21,4.238095238095238
pokemon conquest,0,2,2,4,13,21,4.333333333333333
crosswords ds,0,0,0,11,10,21,4.476190476190476
sonic gems collection - gamecube,1,1,0,5,13,20,4.4
lego jurassic world - xbox 360 standard edition,1,2,2,6,9,20,4.0
xbox 360 universal media remote,1,2,1,5,11,20,4.15
heavy rain and beyond two souls collection hd remastered (playstation 4 ps4),0,0,0,2,18,20,4.9
age of empires iii,2,3,2,9,4,20,3.5
disney infinity 3.0 edition starter pack - wii u,0,0,1,3,16,20,4.75
xbox one wireless controller and play & charge kit,0,1,1,3,15,20,4.6
turtle beach - ear force recon 30x chat communicator gaming headset - xbox one (discontinued by manufacturer),0,3,2,5,10,20,4.1
project x zone 2 - nintendo 3ds,2,2,1,5,10,20,3.95
chibi-robo!: zip lash with chibi-robo amiibo bundle - nintendo 3ds bundle edition,1,1,1,7,10,20,4.2
wolfenstein: the old blood - xbox one,1,0,0,4,15,20,4.6
call of duty: black ops iii - standard edition - pc,4,2,4,5,5,20,3.25
plants vs. zombies garden warfare 2 - xbox one,2,0,0,4,14,20,4.4
we love katamari - playstation 2,1,1,2,7,9,20,4.1
the godfather the game - xbox 360,0,1,1,5,13,20,4.5
shovel knight - wii u,0,0,1,2,17,20,4.8
nintendo wii u 32gb mario kart 8 (pre-installed) deluxe bundle,2,0,3,2,13,20,4.2
mega man legacy collection - ps4 [digital code],1,0,4,4,11,20,4.2
prince of persia the two thrones - playstation 2,0,2,2,5,11,20,4.25
nintendogs lab & friends,0,1,2,7,10,20,4.3
dragon age inquisition - game of the year edition - playstation 4,3,0,1,5,11,20,4.05
hori amiibo card folio officially licensed by nintendo,2,3,2,5,8,20,3.7
mortal kombat unchained - sony psp,0,0,0,6,14,20,4.7
final fantasy xi online: the vana'diel collection 2008 - xbox 360,0,4,6,4,6,20,3.6
shin megami tensei: devil summoner: soul hackers - nintendo 3ds,2,1,0,8,9,20,4.05
puzzle & dragons z + puzzle & dragons super mario bros. - nintendo 3ds,1,1,1,7,10,20,4.2
nyko intercooler slim for ps3,5,3,3,2,7,20,3.15
rock band 3 - playstation 3 (game),1,1,4,2,12,20,4.15
ratchet & clank: quest for booty,1,2,5,4,8,20,3.8
deca sports freedom - xbox 360,6,2,2,3,7,20,3.15
green lantern: rise of the manhunters - playstation 3,1,0,8,4,7,20,3.8
play & charge kit cable only for xbox 360,2,2,2,4,10,20,3.9
divinity ii: the dragon knight saga,0,0,1,4,15,20,4.7
tom clancy's ghost recon shadow wars,1,0,1,6,12,20,4.4
eternal sonata - xbox 360,0,0,6,6,8,20,4.1
nyko charge base for 3ds,2,2,4,2,10,20,3.8
the sims 3: generations - expansion pack pc/mac,0,2,3,5,10,20,4.15
ultimate mortal kombat,0,0,2,4,14,20,4.6
xbox 360 gears of war 3 limited edition console bundle,0,0,0,3,17,20,4.85
disney universe - nintendo wii,0,0,1,5,14,20,4.65
zumba fitness 2 - nintendo wii,0,0,2,5,13,20,4.55
just dance 3,1,1,1,2,15,20,4.45
blades of time - xbox 360,1,0,6,6,7,20,3.9
mortal kombat armageddon,1,1,4,4,10,20,4.05
wwe smackdown vs. raw 2011 - playstation 3,2,1,4,4,9,20,3.85
lego star wars iii the clone wars - xbox 360,1,0,2,4,13,20,4.4
etrian mystery dungeon - nintendo 3ds,0,0,1,2,17,20,4.8
ssx - playstation 3,2,1,4,3,10,20,3.9
tom clancy's endwar - playstation 3,2,0,1,8,9,20,4.1
logitech playstation 3 cordless mediaboard pro,0,0,4,4,12,20,4.4
f.e.a.r. perseus mandate - pc,0,0,4,7,9,20,4.25
wii fit balance board blue silicone sleeve,2,0,0,6,12,20,4.3
x-blades - xbox 360,0,4,5,3,8,20,3.75
saints row 2 - pc,4,0,4,4,8,20,3.6
king of fighters xi - playstation 2,0,1,3,8,8,20,4.15
need for speed: undercover - xbox 360,1,2,5,3,9,20,3.85
kirby super star ultra,0,0,1,3,16,20,4.75
evercool defender turbo cooling fan - playstation 3 (not compatible with ps3 slim),1,0,3,4,12,20,4.3
terminator salvation - xbox 360,4,2,10,0,4,20,2.9
playstation 2 slim console - silver,1,0,1,4,14,20,4.5
call of juarez: bound in blood - xbox 360,3,0,3,7,7,20,3.75
need for speed: shift - playstation 3,1,0,4,2,13,20,4.3
mini ninjas - playstation 3,0,1,2,4,13,20,4.45
fragile dreams: farewell ruins of the moon - nintendo wii,2,0,3,3,12,20,4.15
playstation 3 dualshock 3 wireless controller (red),0,0,1,4,15,20,4.7
ultimate marvel vs. capcom 3 - xbox 360,0,4,1,2,13,20,4.2
xbox 360 wireless headset with bluetooth,2,2,3,2,11,20,3.9
hyperdimension neptunia mk2 - playstation 3,0,1,1,3,15,20,4.6
enchanted arms - playstation 3,1,0,6,8,5,20,3.8
battlefield 2142 (dvd-rom) - pc,6,4,3,3,4,20,2.75
the lego movie videogame - nintendo 3ds standard edition,0,1,2,5,12,20,4.4
call of duty: ghosts hardened edition - playstation 4,2,0,2,5,11,20,4.15
castlevania lords of shadow collection,3,0,1,2,14,20,4.2
the walking dead game of the year - playstation 3,1,0,1,4,14,20,4.5
steam gift card - $100,5,0,3,2,10,20,3.6
tales of the abyss - playstation 2,0,1,3,4,12,20,4.35
"hyperkin ""gn6"" premium controller for genesis",2,1,1,3,13,20,4.2
destroy all humans 2,0,1,0,5,14,20,4.6
xbox one wireless controller - titanfall limited edition,4,0,0,3,13,20,4.05
theatrhythm final fantasy curtain call - limited edition,1,0,0,3,16,20,4.65
playstation gold wireless stereo headset: limited edition - white,2,1,1,3,13,20,4.2
"persona q: shadow of the labyrinth - the wild cards premium edition, nintendo 3ds",0,0,1,5,14,20,4.65
destiny limited edition - playstation 4,1,2,2,2,13,20,4.2
legend of spyro: a new beginning - playstation 2,1,3,6,3,7,20,3.6
pit amiibo - japan import (super smash bros series),1,0,0,0,19,20,4.8
meta knight amiibo - japan import (super smash bros series),0,0,0,1,19,20,4.95
world of warcraft battle chest - (obsolete),1,0,1,3,15,20,4.55
the elder scrolls anthology,0,0,1,2,17,20,4.8
playstation 4 killzone launch day bundle,3,0,1,2,14,20,4.2
wii u pro controller - white,0,1,2,3,14,20,4.5
sony playstation eye camera (bulk packaging),0,0,0,1,19,20,4.95
nyko wireless sensor bar for wii,1,0,4,4,11,20,4.2
nyko power grip for vita - playstation vita 1000 series,2,1,1,3,13,20,4.2
"nyko hd-link for wii, 8ft 2.4m",1,0,2,1,16,20,4.55
lego lord of the rings - playstation vita,0,0,0,5,15,20,4.75
battlefield 3 premium edition -xbox 360,0,1,0,4,15,20,4.65
lightning returns: final fantasy xiii - xbox 360,2,0,3,0,15,20,4.3
ps3 250 gb black friday 2012 bundle,2,0,1,0,17,20,4.5
final fantasy xiv: a realm reborn - playstation 4,4,2,1,2,11,20,3.7
etrian odyssey iv: legends of the titan - nintendo 3ds,2,0,1,2,15,20,4.4
xbox 360 quick charge kit,0,1,1,2,16,20,4.65
genji: days of the blade - playstation 3,1,3,5,2,9,20,3.75
resident evil: revelations - nintendo wii u,1,0,2,4,13,20,4.4
madden nfl 25 - xbox one,1,1,2,5,11,20,4.2
timeshift - pc,1,3,2,10,4,20,3.65
skylanders giants: lightcore hex character,0,1,1,2,16,20,4.65
kinect sports ultimate collection,1,0,0,0,19,20,4.8
bioshock: the collection - xbox one,1,0,2,3,14,20,4.45
wwf smackdown 2: know your role,3,2,0,4,11,20,3.9
burnout revenge - playstation 2,0,0,1,3,16,20,4.75
mortal kombat 4,0,0,4,3,13,20,4.45
madden nfl 2006 - playstation 2,2,4,2,5,7,20,3.55
mortal kombat trilogy,0,1,3,3,13,20,4.4
tony hawk's underground,1,0,2,4,13,20,4.4
super nintendo controller,2,0,4,0,14,20,4.2
star wars: rogue squadron,0,0,1,3,16,20,4.75
earthbound,0,0,0,3,17,20,4.85
resident evil - playstation,1,0,0,4,15,20,4.6
mario golf: toadstool tour,0,0,0,7,13,20,4.65
sonic advance 2,0,0,1,8,11,20,4.5
need for speed: most wanted (greatest hits),0,0,2,5,13,20,4.55
radiata stories - playstation 2,1,3,3,5,8,20,3.8
crazy taxi 2 - sega dreamcast,0,1,5,4,10,20,4.15
freelancer - pc,1,1,4,6,8,20,3.95
return to castle wolfenstein: operation resurrection - playstation 2,3,0,2,6,9,20,3.9
twisted metal 4,0,1,5,2,12,20,4.25
empire earth - pc,0,1,2,7,10,20,4.3
diablo 2 expansion: lord of destruction - pc/mac,0,0,2,8,10,20,4.4
project gotham racing 2 - xbox,0,0,1,6,13,20,4.6
baldur's gate ii:  shadows of amn,0,3,1,2,14,20,4.35
simcity 4 - pc,3,2,0,10,5,20,3.6
metal gear solid 2: substance,0,4,3,7,6,20,3.75
call of duty: united offensive expansion pack - pc (deluxe),1,1,2,4,12,20,4.25
mega man - nintendo nes,1,2,2,6,9,20,4.0
wreckless: the yakuza missions,0,5,7,5,3,20,3.3
hitman 2: silent assassin - pc,2,0,2,7,9,20,4.05
espn nfl 2k5 - xbox,0,0,0,4,16,20,4.8
xbox controller s,1,2,1,8,8,20,4.0
gauntlet: dark legacy,0,0,2,9,9,20,4.35
turok: evolution,2,2,7,4,5,20,3.4
star wars: clone wars,1,1,3,4,11,20,4.15
doom 3: resurrection of evil expansion pack,1,1,8,5,5,20,3.6
the lord of the rings: the battle for middle-earth,3,0,1,7,9,20,3.95
madden nfl 2005 - ps2,1,2,1,5,11,20,4.15
mercenaries - xbox,0,0,2,3,15,20,4.65
visual memory unit - blue,0,0,0,2,18,20,4.9
time splitters 2,0,1,3,7,9,20,4.2
lara croft tomb raider: the  angel of darkness,3,6,3,4,4,20,3.0
thief 3: deadly shadows - pc,0,2,3,6,9,20,4.1
socom: fireteam bravo - sony psp,1,1,0,6,12,20,4.35
mario power tennis,0,0,1,3,16,20,4.75
shin megami tensei: digital devil saga - playstation 2,0,0,2,6,12,20,4.5
super game boy,0,1,0,2,17,20,4.75
half-life: blue shift - pc,0,3,9,5,3,20,3.4
metro last light - xbox 360,0,0,5,5,9,19,4.2105263157894735
dead or alive 2: hardcore,0,2,1,7,9,19,4.2105263157894735
twisted metal iii,3,2,5,3,6,19,3.3684210526315788
the walking dead: season 2 - xbox one,0,0,0,5,14,19,4.7368421052631575
tony hawk's pro skater 4 - playstation 2,0,0,1,6,12,19,4.578947368421052
5 pair/10 pcs replacement silicone analog controller joystick thumb stick grips cap cover for ps3 / ps4 / xbox 360 / xbox one / wii game controllers by trineybell,0,0,1,4,14,19,4.684210526315789
need for speed hot pursuit - pc,2,2,2,5,8,19,3.789473684210526
super monkey ball,0,0,3,3,13,19,4.526315789473684
sonic boom: shattered crystal - nintendo 3ds,2,0,3,1,13,19,4.2105263157894735
turtle beach call of duty: ghosts ear force shadow limited edition gaming headset -microsoft xbox 360,1,1,2,3,12,19,4.2631578947368425
wheel of fortune - nintendo wii,0,0,0,5,14,19,4.7368421052631575
wwe all stars - playstation 3,1,1,2,6,9,19,4.105263157894737
the sims 3: showtime - pc/mac,1,0,5,4,9,19,4.052631578947368
superman returns - xbox 360,3,5,4,4,3,19,2.9473684210526314
hot shots golf: open tee 2 - sony psp,0,0,0,6,13,19,4.684210526315789
disney infinity: marvel super heroes (2.0 edition) captain america figure - not machine specific,0,0,1,2,16,19,4.7894736842105265
mario & sonic at the sochi 2014 olympic winter games - nintendo wii u,3,0,4,4,8,19,3.736842105263158
persona q: shadow of the labyrinth - nintendo 3ds standard edition,0,0,2,1,16,19,4.7368421052631575
unreal tournament 2004,0,0,1,2,16,19,4.7894736842105265
ps3 500gb the last of us bundle,1,1,1,4,12,19,4.315789473684211
south park,0,3,1,2,13,19,4.315789473684211
skylanders swap force starter pack - playstation 4,0,0,1,2,16,19,4.7894736842105265
kontrolfreek fps vipr,1,1,2,6,9,19,4.105263157894737
batman: the video game,0,0,0,4,15,19,4.7894736842105265
pokemon ranger: guardian signs,0,0,1,1,17,19,4.842105263157895
just dance 2015 - wii u,0,0,1,3,15,19,4.7368421052631575
turok 2: seeds of evil,0,1,3,4,11,19,4.315789473684211
pokemon omega ruby and pokemon alpha sapphire dual pack - nintendo 3ds,0,0,1,1,17,19,4.842105263157895
mortal kombat deadly alliance,0,1,4,10,4,19,3.8947368421052633
wwe 2k16 - xbox one,0,2,4,5,8,19,4.0
wario ware: mega microgames,0,1,1,4,13,19,4.526315789473684
neverwinter nights - pc,2,0,4,7,6,19,3.789473684210526
brothers - a tale of two sons [online game code],2,0,1,4,12,19,4.2631578947368425
chicken riot - nintendo wii,0,0,4,4,11,19,4.368421052631579
fire emblem,0,0,0,5,14,19,4.7368421052631575
transformers: fall of cybertron - xbox 360,0,0,4,5,10,19,4.315789473684211
wario world | gamecube,0,2,2,5,10,19,4.2105263157894735
battlefield 2 modern combat - xbox 360,1,1,2,7,8,19,4.052631578947368
sherlock holmes: crimes & punishments - playstation 4,0,1,2,9,7,19,4.157894736842105
xbox 360 500gb media hard drive,0,0,1,3,15,19,4.7368421052631575
viva piñata: trouble in paradise,0,0,4,6,9,19,4.2631578947368425
nba live 14 - playstation 4,3,4,2,4,6,19,3.3157894736842106
dying light - pc,1,1,3,5,9,19,4.052631578947368
harvest moon magical melody - gamecube,0,1,2,3,13,19,4.473684210526316
generic sony playstation 3 slim edition ac power adapter cord bulk,0,1,1,5,12,19,4.473684210526316
need for speed: prostreet - playstation 3,0,1,3,5,10,19,4.2631578947368425
need for speed: the run [download],3,3,4,3,6,19,3.3157894736842106
suikoden v - playstation 2,0,0,3,4,12,19,4.473684210526316
starcraft ii: heart of the swarm -collector's edition,0,1,0,3,15,19,4.684210526315789
virtua fighter 4 evolution - playstation 2,2,2,1,2,12,19,4.052631578947368
dead to rights: retribution - playstation 3,0,1,8,4,6,19,3.789473684210526
mushroom men: the spore wars - nintendo wii,2,0,0,4,13,19,4.368421052631579
guitar hero metallica - playstation 3,0,0,1,4,14,19,4.684210526315789
zombie army trilogy - playstation 4,0,1,2,7,9,19,4.2631578947368425
age of conan: hyborian adventures - pc,3,5,7,2,2,19,2.736842105263158
sega alien: isolation - xbox 360 standard edition,1,3,0,4,11,19,4.105263157894737
thief - playstation 3,1,1,5,2,10,19,4.0
lightning360 high quality premium super grip glow black blue silicon protective skin case cover for sony playstation ps3 remote controller,0,1,4,3,11,19,4.2631578947368425
star wars: battlefront & steelbook (amazon exclusive) - playstation 4,4,3,4,4,4,19,3.0526315789473686
mario and sonic at the olympic winter games - nintendo wii,1,0,1,5,12,19,4.421052631578948
mario tennis:  ultra smash,1,3,4,3,8,19,3.736842105263158
"ds, game boy advance sp rapid home travel charger with ic chip",3,1,1,0,14,19,4.105263157894737
"call of duty legacy (includes finest hour, big red one) - playstation 2",0,1,0,2,16,19,4.7368421052631575
naruto shippuden: ultimate ninja storm revolution - playstation 3,0,0,2,1,16,19,4.7368421052631575
wasteland 2: director's cut,3,1,2,4,9,19,3.789473684210526
wipeout in the zone - xbox 360,0,3,2,3,11,19,4.157894736842105
lost: via domus - xbox 360,4,0,14,0,1,19,2.6842105263157894
turok - pc,4,2,9,4,0,19,2.6842105263157894
steins;gate - playstation vita,0,0,0,1,18,19,4.947368421052632
dead island definitive collection - playstation 4,3,0,3,3,10,19,3.8947368421052633
sega superstars tennis - xbox 360,0,0,5,11,3,19,3.8947368421052633
twisted metal 2,0,0,1,0,18,19,4.894736842105263
"3 pack - limbo, trials hd, splosion man - xbox 360",0,0,5,6,8,19,4.157894736842105
sonic heroes - playstation 2,0,0,1,3,15,19,4.7368421052631575
starcraft ii: legacy of the void - standard edition,0,1,0,3,15,19,4.684210526315789
star wars: republic commando,0,0,1,8,10,19,4.473684210526316
legobatman2: dc super heroes - playstation vita,1,2,1,1,14,19,4.315789473684211
pikmin & olimar amiibo (super smash bros series),0,0,0,2,17,19,4.894736842105263
dragon age inquisition - deluxe edition -  xbox one,1,0,2,3,13,19,4.421052631578948
metal slug anthology - nintendo wii,1,0,4,3,11,19,4.2105263157894735
midnight club: los angeles - xbox 360,0,4,1,6,8,19,3.9473684210526314
xcom: enemy within  - xbox 360,1,1,1,1,15,19,4.473684210526316
dragon ball z: budokai 3 - playstation 2,0,0,1,4,14,19,4.684210526315789
madden nfl 15 - playstation 3,3,2,2,1,11,19,3.789473684210526
no man's sky - limited edition - playstation 4,1,4,3,4,7,19,3.6315789473684212
star wars galaxies: an empire divided - pc,9,2,0,5,3,19,2.526315789473684
syberia - pc,2,1,2,6,8,19,3.8947368421052633
supreme commander - pc,2,7,2,2,6,19,3.1578947368421053
midway arcade treasures 2 - playstation 2,0,0,2,8,9,19,4.368421052631579
ps3 move quad charger,1,1,1,1,15,19,4.473684210526316
dragon ball z: battle of z - playstation 3,1,2,1,3,12,19,4.2105263157894735
transformers rise of the dark spark - playstation 4,3,3,3,3,7,19,3.4210526315789473
castlevania: harmony of dissonance,0,0,6,5,8,19,4.105263157894737
dark messiah of might & magic - pc,1,3,4,7,4,19,3.526315789473684
wii hardware bundle - red,1,0,1,2,15,19,4.578947368421052
zoo tycoon: complete collection - pc,0,0,2,0,17,19,4.7894736842105265
trials fusion - playstation 4,0,1,1,0,17,19,4.7368421052631575
pdp afterglow prismatic wired controller for xbox one - xbox one,1,1,0,6,11,19,4.315789473684211
skylanders spyro's adventure: hex,0,1,1,3,14,19,4.578947368421052
star fox command,0,1,6,9,3,19,3.736842105263158
link's crossbow training,0,0,2,10,7,19,4.2631578947368425
g155-gaming and entertainment mobile system (xbox 360/ ps3 not included),1,1,0,5,12,19,4.368421052631579
xbox 360 messenger kit,0,1,1,7,10,19,4.368421052631579
alone in the dark - playstation 2,6,8,2,0,3,19,2.263157894736842
xbox live 12 month gold starter kit,0,0,2,3,14,19,4.631578947368421
fallout 4 - pip-boy edition - pc,2,0,3,5,9,19,4.0
dragonpad wii to hdmi converter output video audio adapter - supports all wii display modes to 720p / 1080p hdtv & monitor.,0,1,0,4,14,19,4.631578947368421
wwe 2k15 - xbox one,2,1,2,3,11,19,4.052631578947368
crash bandicoot: twinsanity - playstation 2,2,1,4,3,9,19,3.8421052631578947
hori ps vita screen protective filter,2,2,1,2,12,19,4.052631578947368
nintendo 64 rumble pak (nus-013),2,0,1,2,14,19,4.368421052631579
psychonauts,0,0,3,5,11,19,4.421052631578948
call of duty finest hour,0,1,5,3,10,19,4.157894736842105
sony psp battery pack,2,0,2,4,11,19,4.157894736842105
diablo iii: reaper of souls collector's edition,1,0,0,4,14,19,4.578947368421052
conan - playstation 3,0,0,3,7,9,19,4.315789473684211
nintendo - new 3ds xl legend of zelda: majora's mask limited edition - gold/black,6,0,0,2,11,19,3.6315789473684212
celeste amiibo (animal crossing series),1,0,1,3,14,19,4.526315789473684
disney infinity starter pack xbox 360,4,0,0,4,11,19,3.9473684210526314
sly 3 honor among thieves - playstation 2,0,0,2,1,16,19,4.7368421052631575
deus ex: human revolution - standard edition [download],1,2,2,4,10,19,4.052631578947368
gran turismo - sony psp,2,0,4,5,8,19,3.8947368421052633
star wars obi-wan,2,3,3,7,4,19,3.4210526315789473
lego the hobbit - playstation 4,0,0,1,3,15,19,4.7368421052631575
castlevania: aria of sorrow,0,0,0,4,15,19,4.7894736842105265
ultimate nes remix - nintendo 3ds,1,0,1,4,13,19,4.473684210526316
madden nfl 2006 - xbox 360,3,6,0,7,3,19,3.0526315789473686
command & conquer: generals - pc,0,0,4,9,6,19,4.105263157894737
ace attorney investigations: miles edgeworth,0,0,2,6,11,19,4.473684210526316
peter jackson's king kong - xbox 360,1,1,7,7,3,19,3.526315789473684
big brain academy: wii degree,2,1,4,6,6,19,3.6842105263157894
zelda ii: the adventure of link (classic nes series),0,1,2,5,11,19,4.368421052631579
rayman legends xbox one standard edition,1,0,2,0,16,19,4.578947368421052
trace memory - nintendo ds,0,0,3,10,6,19,4.157894736842105
return to castle wolfenstein: tides of war - xbox,0,2,1,3,13,19,4.421052631578948
lego jurassic world - wii u,0,0,0,2,17,19,4.894736842105263
sonic & sega all-stars racing - playstation 3,0,0,2,4,13,19,4.578947368421052
namco museum: 50th anniversary,1,0,1,7,10,19,4.315789473684211
shadowrun - xbox 360,2,2,5,6,4,19,3.4210526315789473
the pinball arcade - playstation 4,0,1,2,2,14,19,4.526315789473684
simpsons hit and run - gamecube,0,1,3,3,12,19,4.368421052631579
f-zero,0,0,5,5,9,19,4.2105263157894735
guilty gear xrd sign limited edition - playstation 4,0,0,0,4,15,19,4.7894736842105265
the sims 2: nightlife expansion pack - pc,0,0,1,3,15,19,4.7368421052631575
donkey kong country 2: diddy's kong quest,0,0,1,3,15,19,4.7368421052631575
crazy taxi,0,1,7,5,5,18,3.7777777777777777
wwe day of reckoning - gamecube,0,2,0,5,11,18,4.388888888888889
mario kart wii,0,0,1,1,16,18,4.833333333333333
the sims: house party expansion pack - pc,0,1,1,6,10,18,4.388888888888889
the witcher 2: assassins of kings - enhanced edition - xbox 360,1,0,1,5,11,18,4.388888888888889
lunar: silver star story complete,0,0,0,5,13,18,4.722222222222222
sonic & knuckles,0,0,0,7,11,18,4.611111111111111
super mario land 2: 6 golden coins,0,0,0,2,16,18,4.888888888888889
wave race: blue storm,0,0,3,6,9,18,4.333333333333333
the sims 2 happy holiday stuff - pc,0,2,2,3,11,18,4.277777777777778
danganronpa 2: goodbye despair - playstation vita,0,0,1,2,15,18,4.777777777777778
turtle beach - ear force stealth 500x premium fully wireless with surround sound gaming headset - xbox one,5,2,1,4,6,18,3.2222222222222223
amazing adventures: the forgotten ruins - nintendo ds,0,2,2,8,6,18,4.0
tactics ogre: let us cling together - sony psp,0,0,1,4,13,18,4.666666666666667
haunting ground - playstation 2,0,0,1,7,10,18,4.5
life is strange limited edition - playstation 4,1,1,0,5,11,18,4.333333333333333
the legend of zelda: collector's edition (zelda / zelda ii: the adventure of link / ocarina of time / majora's mask),1,0,0,5,12,18,4.5
ssx,0,1,0,1,16,18,4.777777777777778
rock band for xbox 360,1,2,0,2,13,18,4.333333333333333
soldier of fortune ii double helix,0,3,3,7,5,18,3.7777777777777777
max payne 2: the fall of max payne - xbox,0,0,2,5,11,18,4.5
resident evil 2,0,1,1,4,12,18,4.5
heroes of ruin - nintendo 3ds,0,2,3,8,5,18,3.888888888888889
professor layton and the miracle mask - nintendo 3ds,0,1,2,3,12,18,4.444444444444445
the crew - xbox one,1,3,3,3,8,18,3.7777777777777777
star wars: the old republic collector's bundle - pc,0,2,2,6,8,18,4.111111111111111
nba 2k14 - xbox one,1,2,1,5,9,18,4.055555555555555
fable: the journey - xbox 360,1,1,4,1,11,18,4.111111111111111
lego indiana jones 2: the adventure continues - playstation 3,0,1,3,5,9,18,4.222222222222222
disney infinity: marvel super heroes (2.0 edition) video game starter pack - wii u,0,3,1,1,13,18,4.333333333333333
blood omen 2,1,1,7,6,3,18,3.5
disney infinity: marvel super heroes (2.0 edition) video game starter pack - playstation 4,0,0,5,5,8,18,4.166666666666667
dead or alive ultimate,1,0,1,4,12,18,4.444444444444445
disney infinity 3.0 edition: star wars yoda figure,0,0,0,0,18,18,5.0
wwe all stars - xbox 360,0,0,3,4,11,18,4.444444444444445
xbox 360 wireless controller with transforming d-pad and play and charge kit - black,0,0,0,1,17,18,4.944444444444445
carnival island - playstation 3,0,1,0,1,16,18,4.777777777777778
sword of mana,0,2,4,5,7,18,3.9444444444444446
mario party star rush - nintendo 3ds,0,0,2,5,11,18,4.5
pokemon mystery dungeon: explorers of time,0,0,0,4,14,18,4.777777777777778
final fantasy type-0 hd - xbox one,0,1,1,2,14,18,4.611111111111111
the order: 1886 premium edition,0,0,2,7,9,18,4.388888888888889
resident evil: revelations 2 - xbox one,1,1,2,2,12,18,4.277777777777778
little big planet 3 - playstation 3,0,1,2,1,14,18,4.555555555555555
jeopardy - nintendo wii,0,0,2,6,10,18,4.444444444444445
hitman: blood money - xbox 360,1,0,1,6,10,18,4.333333333333333
analog av multi out to component cable for playstation 3/ps2,2,1,0,3,12,18,4.222222222222222
insten crystal case compatible with nintendo 3ds xl (not compatible with the new version),0,0,1,2,15,18,4.777777777777778
mario kart: double dash!! with bonus disc,0,0,2,6,10,18,4.444444444444445
dirt rally - playstation 4,4,1,2,3,8,18,3.5555555555555554
skylanders spyro's adventure pack - pirate seas,0,0,1,4,13,18,4.666666666666667
dragon warrior vii,0,4,1,2,11,18,4.111111111111111
pokémon yellow version - 3ds [digital code],1,0,0,2,15,18,4.666666666666667
rayman 3d - nintendo 3ds,0,1,4,6,7,18,4.055555555555555
ninja gaiden,0,0,2,4,12,18,4.555555555555555
just cause 2 [online game code],1,1,3,4,9,18,4.055555555555555
rocket league: collector's edition - playstation 4,0,0,2,0,16,18,4.777777777777778
star wars: battlefront,2,1,4,7,4,18,3.5555555555555554
mega man amiibo - japan import (super smash bros series),2,0,0,1,15,18,4.5
odin sphere leifthrasir - playstation 4 standard edition,3,1,0,1,13,18,4.111111111111111
silent hill 4 the room - xbox,0,2,6,2,8,18,3.888888888888889
tom clancy's splinter cell 3d - nintendo 3ds,2,3,3,1,9,18,3.6666666666666665
captain falcon amiibo - japan import (super smash bros series),1,0,1,1,15,18,4.611111111111111
turtle beach - ear force xo seven pro premium gaming headset - superhuman hearing - xbox one (discontinued by manufacturer),3,1,1,2,11,18,3.9444444444444446
puzzle quest: challenge of the warlords - nintendo ds,1,0,4,5,8,18,4.055555555555555
gothic universe - pc,4,2,0,6,6,18,3.4444444444444446
the sims 2 glamour life stuff - pc,0,3,1,1,13,18,4.333333333333333
fuzion frenzy - xbox,0,2,4,6,6,18,3.888888888888889
sega genesis 1 (original model) console system,0,0,0,3,15,18,4.833333333333333
age of empires collector's edition (limited edition),1,1,1,5,10,18,4.222222222222222
metal gear solid portable ops - sony psp,1,0,1,4,12,18,4.444444444444445
psp battery pack,2,0,6,2,8,18,3.7777777777777777
dead or alive xtreme 2,0,4,2,3,9,18,3.9444444444444446
xbox 360 wireless controller pink,0,2,4,2,10,18,4.111111111111111
hori hard pouch for nintendo new 3ds xl,0,0,0,4,14,18,4.777777777777778
need for speed carbon - playstation 2,0,0,2,6,10,18,4.444444444444445
kirby squeak squad,0,0,2,5,11,18,4.5
mortal kombat x fight pad for xbox one and xbox 360,3,1,6,3,5,18,3.3333333333333335
need for speed shift,2,0,4,3,9,18,3.9444444444444446
waddle dee amiibo - nintendo 3ds,1,0,0,4,13,18,4.555555555555555
kirby amiibo - nintendo 3ds,0,0,0,1,17,18,4.944444444444445
the serious sam collection - xbox 360,0,3,2,2,11,18,4.166666666666667
shadow hearts: covenant,0,0,1,3,14,18,4.722222222222222
sid meier's pirates! (live the life),1,3,3,5,6,18,3.6666666666666665
hitman 2:  silent assassin - playstation 2,2,1,2,6,7,18,3.8333333333333335
mmr umd psp replacement game case 3 pack clear,0,0,0,0,18,18,5.0
nancy drew: the legend of the crystal skull - pc,2,3,1,5,7,18,3.6666666666666665
skylanders superchargers: drivers high volt character pack,0,0,1,0,17,18,4.888888888888889
mizar replacement  av cables + ac power cord for xbox,0,0,0,0,18,18,5.0
nier - xbox 360,2,1,2,2,11,18,4.055555555555555
hitman: the complete first season - playstation 4,2,0,1,3,12,18,4.277777777777778
ncaa football 14 - playstation 3,1,0,0,4,13,18,4.555555555555555
fire emblem: radiant dawn,0,3,2,4,9,18,4.055555555555555
mvp baseball 2005,0,0,2,4,12,18,4.555555555555555
goldeneye 007: reloaded,1,1,6,2,8,18,3.8333333333333335
hori screen protective filter for playstation vita 2000 series,1,0,0,3,14,18,4.611111111111111
alice: madness returns - pc,0,0,6,7,5,18,3.9444444444444446
major league baseball 2k11 - xbox 360,2,2,3,4,7,18,3.6666666666666665
timesplitters 2,0,0,2,6,10,18,4.444444444444445
mlb 15: the show (10th anniversary edition),2,0,0,0,16,18,4.555555555555555
saints row iv [download],0,1,2,7,8,18,4.222222222222222
cirka wired controller for gamecube/ wii (purple),3,1,2,5,7,18,3.6666666666666665
zoo tycoon - pc,0,1,6,1,10,18,4.111111111111111
mystery case files: ravenhearst,1,1,0,3,13,18,4.444444444444445
ps3 250gb the last of us bundle,2,0,0,1,15,18,4.5
republique - playstation 4,2,1,2,5,8,18,3.888888888888889
xbox memory unit,0,2,1,4,11,18,4.333333333333333
lego indiana jones: the original adventures - playstation 2,0,0,0,4,14,18,4.777777777777778
skylanders swap force fiery forge battle pack,0,0,3,0,15,18,4.666666666666667
blazblue: chrono phantasma - playstation 3,1,0,1,2,14,18,4.555555555555555
turtle beach - ear force x42 - premium wireless gaming headset with dolby surround sound - xbox 360 (discontinued by manufacturer),2,0,4,3,9,18,3.9444444444444446
kinect adventures! xbox 360,0,1,3,4,10,18,4.277777777777778
call of duty finest hour - playstation 2,0,2,3,3,10,18,4.166666666666667
dead or alive 5,0,1,3,2,12,18,4.388888888888889
ghostbusters: the video game - playstation 2,0,0,2,10,6,18,4.222222222222222
pokemon xd: gale of darkness,0,0,2,1,15,18,4.722222222222222
deus ex: game of the year edition - pc,0,0,1,4,13,18,4.666666666666667
disney princess: enchanted journey - nintendo wii,1,0,3,3,11,18,4.277777777777778
conker: live & reloaded - xbox,0,0,4,4,10,18,4.333333333333333
street fighter ii,1,0,1,5,11,18,4.388888888888889
the king of fighters xiii - playstation 3,1,0,1,5,11,18,4.388888888888889
ufc undisputed 3,1,0,3,7,7,18,4.055555555555555
pro evolution soccer 2014 - ps3,0,1,3,0,14,18,4.5
the sims 3 high end loft stuff [instant access],2,2,2,0,12,18,4.0
forza motorsport,0,0,1,2,15,18,4.777777777777778
kirby canvas curse,1,0,0,9,8,18,4.277777777777778
velvet assassin - xbox 360,3,1,3,4,7,18,3.611111111111111
dark pit amiibo - japan import (super smash bros series),0,0,0,1,17,18,4.944444444444445
kirby air ride,0,1,1,4,12,18,4.5
wii fit u w/fit meter - wii u,0,1,0,9,8,18,4.333333333333333
far cry instincts predator - xbox 360,2,2,3,7,4,18,3.5
lego pirates of the caribbean - nintendo 3ds,0,1,3,5,9,18,4.222222222222222
rune factory 2: a fantasy harvest moon - nintendo ds,0,1,1,8,8,18,4.277777777777778
psp playgear pocket,1,0,1,6,10,18,4.333333333333333
ness amiibo - japan import (super smash bros series),0,0,1,2,15,18,4.777777777777778
xbox one s 500gb console - halo collection bundle [discontinued],4,0,1,3,10,18,3.8333333333333335
lords of the fallen playstation 4 complete edition,2,2,3,3,8,18,3.7222222222222223
fifa soccer 11 - playstation 3,0,0,3,2,13,18,4.555555555555555
grandia iii - playstation 2,0,2,4,3,9,18,4.055555555555555
hitman trilogy hd premium edition - playstation 3,1,0,2,2,13,18,4.444444444444445
kirby nightmare in dream land,1,1,2,7,7,18,4.0
the sims 2: celebration stuff - pc,0,2,4,2,10,18,4.111111111111111
jigglypuff amiibo - japan import (super smash bros series),0,0,0,1,17,18,4.944444444444445
resident evil: dead aim,3,0,2,4,9,18,3.888888888888889
guitar hero world tour - xbox 360 (game only),1,2,2,3,10,18,4.055555555555555
dirt 2 - xbox 360,1,0,3,4,10,18,4.222222222222222
tom clancy's ghost recon - xbox,0,1,2,8,7,18,4.166666666666667
medal of honor: rising sun - xbox,1,1,2,6,8,18,4.055555555555555
destiny: rise of iron - ps4 [digital code],3,6,5,1,3,18,2.7222222222222223
borderlands 2 - pc,1,1,1,0,15,18,4.5
ghost trick: phantom detective - nintendo ds,1,0,2,4,11,18,4.333333333333333
spider-man,0,4,2,5,7,18,3.8333333333333335
wii music,2,2,1,4,9,18,3.888888888888889
resident evil code veronica x - gamecube,0,0,2,3,13,18,4.611111111111111
shinobi - nintendo 3ds,0,0,1,9,8,18,4.388888888888889
toy story 3 the video game - playstation 2,0,1,0,2,15,18,4.722222222222222
super street fighter ii: the new challengers,0,0,2,3,13,18,4.611111111111111
"xbox one with kinect: assassin's creed unity bundle, 500gb hard drive",2,0,0,2,14,18,4.444444444444445
retro-bit super retrotrio console nes/snes/genesis 3-in-1 system - red/black,1,2,2,4,9,18,4.0
no more heroes: heroes' paradise - playstation 3,1,5,2,3,7,18,3.5555555555555554
dead or alive 5 last round - xbox one,2,2,3,4,7,18,3.6666666666666665
battlefield 3: premium edition [online game code],1,1,0,3,13,18,4.444444444444445
mario party 3,1,0,3,4,10,18,4.222222222222222
saints row: the third [download],1,1,1,4,11,18,4.277777777777778
gunstringer - xbox 360,0,1,2,6,9,18,4.277777777777778
mortal kombat,1,2,1,3,11,18,4.166666666666667
skylanders spyro's adventure: drobot,0,0,1,2,15,18,4.777777777777778
the bouncer,1,4,4,4,5,18,3.4444444444444446
hellgate: london - pc,4,3,6,2,3,18,2.8333333333333335
madden nfl 2004,1,0,0,5,12,18,4.5
the chronicles of riddick: assault on dark athena - pc,11,0,2,1,3,17,2.1176470588235294
the movies - pc,1,1,4,6,5,17,3.764705882352941
lego harry potter: years 5-7 - xbox 360,0,0,1,2,14,17,4.764705882352941
nights journey of dreams - nintendo wii,1,0,5,7,4,17,3.764705882352941
lego indiana jones: the original adventures,0,0,4,4,9,17,4.294117647058823
james bond 007: quantum of solace - pc,2,1,6,5,3,17,3.3529411764705883
the last of us: left behind dlc - ps3 [digital code],1,1,1,2,12,17,4.352941176470588
xbox 360 elite [old version],4,2,0,3,8,17,3.5294117647058822
guitar hero 5 - xbox 360 (game only),2,2,1,2,10,17,3.9411764705882355
rise of nations - pc,0,2,3,3,9,17,4.117647058823529
blood rayne,0,1,5,4,7,17,4.0
lego city undercover: the chase begins - nintendo 3ds,0,1,1,3,12,17,4.529411764705882
sniper elite v2: silver star edition - xbox 360,0,0,3,4,10,17,4.411764705882353
mega man x4,2,0,0,3,12,17,4.352941176470588
the outfit - xbox 360,1,0,4,5,7,17,4.0
payday 2 - playstation 3,1,3,1,2,10,17,4.0
final fantasy v advance (eu),0,0,0,8,9,17,4.529411764705882
deus ex: invisible war - pc,2,1,6,6,2,17,3.2941176470588234
nintendo 3ds hand grip,0,0,2,3,12,17,4.588235294117647
tom clancy's splinter cell double agent - playstation 3,0,2,2,3,10,17,4.235294117647059
playstation 4 1tb console - call of duty: black ops 3 limited edition bundle [discontinued],2,0,0,2,13,17,4.411764705882353
sony playstation 3 move motion controller (bulk packaging),1,0,0,2,14,17,4.647058823529412
etrian odyssey 2 untold: the fafnir knight - nintendo 3ds,0,0,1,4,12,17,4.647058823529412
sony playstation dualshock controller - gray,0,0,0,6,11,17,4.647058823529412
lego jurassic world - playstation 3,0,0,2,3,12,17,4.588235294117647
ridge racer 7 - playstation 3,1,3,1,4,8,17,3.8823529411764706
nba street - playstation 2,0,0,0,6,11,17,4.647058823529412
cooking mama: cook off,0,1,3,7,6,17,4.0588235294117645
batman: arkham knight - windows standard edition,8,1,1,3,4,17,2.6470588235294117
cursed mountain - nintendo wii,1,2,3,5,6,17,3.764705882352941
nintendo ds lite crimson & black with brain age 2,0,0,0,2,15,17,4.882352941176471
black & white 2 - pc,2,4,2,1,8,17,3.5294117647058822
tony hawk's underground 2 - playstation 2,1,1,3,2,10,17,4.117647058823529
akiba's trip: undead & undressed - playstation vita,0,1,3,6,7,17,4.117647058823529
the sims 4 [online game code],2,0,5,5,5,17,3.6470588235294117
klonoa 2: lunatea's veil,0,0,0,7,10,17,4.588235294117647
stella glow - nintendo 3ds,0,1,0,3,13,17,4.647058823529412
disney infinity 3.0 edition: star wars rise against the empire play set,1,0,1,1,14,17,4.588235294117647
godzilla: save the earth,0,1,0,2,14,17,4.705882352941177
dr. mario,0,0,2,5,10,17,4.470588235294118
ssx tricky - playstation 2,0,0,1,5,11,17,4.588235294117647
capcom classics collection volume 2,0,0,2,3,12,17,4.588235294117647
yoshi touch and go,0,1,7,4,5,17,3.764705882352941
tekken hybrid - playstation 3,0,1,4,4,8,17,4.117647058823529
xbox 360 live vision camera,0,1,4,5,7,17,4.0588235294117645
little mac amiibo - japan import (super smash bros series),0,0,1,1,15,17,4.823529411764706
batman arkham city goty [download],0,0,1,1,15,17,4.823529411764706
resident evil 4 - xbox one standard edition,1,1,2,1,12,17,4.294117647058823
ufc personal trainer - xbox 360,1,2,1,3,10,17,4.117647058823529
fishing resort - nintendo wii,0,1,2,2,12,17,4.470588235294118
gravity falls: legend of the gnome gemulets - nintendo 3ds standard edition,1,0,4,9,3,17,3.764705882352941
warhammer 40k: dawn of war soulstorm,0,0,2,9,6,17,4.235294117647059
boom blox bash party - nintendo wii,0,0,0,3,14,17,4.823529411764706
cruis'n usa,0,1,4,1,11,17,4.294117647058823
lunar: silver star harmony - sony psp,1,0,2,4,10,17,4.294117647058823
clive barker's undying - pc,0,1,2,7,7,17,4.176470588235294
house of 1000 doors: family secrets  [download],0,0,2,4,11,17,4.529411764705882
mysims agents - nintendo wii,0,0,3,2,12,17,4.529411764705882
asphalt 3d,2,0,5,6,4,17,3.588235294117647
star wars the clone wars: lightsaber duels - nintendo wii,0,1,4,7,5,17,3.9411764705882355
james bond 007: from russia with love - playstation 2,0,0,2,5,10,17,4.470588235294118
game genie video game enhancer,0,0,0,2,15,17,4.882352941176471
legend of zelda box set prima official game guide,0,0,0,1,16,17,4.9411764705882355
lego battles: ninjago - nintendo ds,1,1,3,3,9,17,4.0588235294117645
xbox 360 arcade,2,0,1,3,11,17,4.235294117647059
dark souls collector's edition - playstation 3,1,0,1,2,13,17,4.529411764705882
tomee charge cable for wii u gamepad,0,0,0,2,15,17,4.882352941176471
official nintendo wii wheel - black,0,0,0,3,14,17,4.823529411764706
wii classic controller pro - white (japanese version),0,0,0,2,15,17,4.882352941176471
senran kagura shinovi versus - 'let's get physical' limited edition - playstation vita,1,1,2,3,10,17,4.176470588235294
blood rayne 2,0,0,2,7,8,17,4.352941176470588
doom,2,2,2,4,7,17,3.7058823529411766
clock tower 3 - playstation 2,0,0,4,6,7,17,4.176470588235294
pdp energizer xbox one controller charger with rechargeable battery pack for two wireless controllers charging station  black (package may vary),2,0,2,0,13,17,4.294117647058823
spider-man 2 - xbox,1,1,2,6,7,17,4.0
tony hawks' pro skater 3,0,0,1,5,11,17,4.588235294117647
action replay dsi,2,0,4,2,9,17,3.9411764705882355
marvel ultimate alliance - playstation 3,0,0,1,4,12,17,4.647058823529412
spider-man 3 - xbox 360,0,1,5,4,7,17,4.0
saints row: gat out of hell,1,0,3,3,10,17,4.235294117647059
metal slug anthology - playstation 2,0,0,0,6,11,17,4.647058823529412
f1: formula one championship edition - playstation 3,0,0,2,6,9,17,4.411764705882353
medieval ii total war - pc,2,0,2,5,8,17,4.0
james bond 007 everything or nothing - gamecube,0,2,4,4,7,17,3.9411764705882355
generic ac adapter for nintendo ds and game boy advance sp - nintendo ds,1,0,2,3,11,17,4.352941176470588
grand theft auto: san andreas - xbox,0,1,0,3,13,17,4.647058823529412
blood omen 2,0,1,5,2,9,17,4.117647058823529
tzou ac power adapter for nintendo wii console,0,0,0,1,16,17,4.9411764705882355
star wars battlefront ii,0,3,2,1,11,17,4.176470588235294
yakuza 2 - playstation 2,0,0,0,6,11,17,4.647058823529412
dragon ball z: budokai tenkaichi 3 - playstation 2,0,2,0,6,9,17,4.294117647058823
electronic arts sports: rory mcilroy pga tour - xbox one,6,4,4,3,0,17,2.235294117647059
ikaruga,0,0,0,3,14,17,4.823529411764706
saw - playstation 3,1,1,3,4,8,17,4.0
nascar 09 - playstation 3,0,0,0,8,9,17,4.529411764705882
tom clancy's the division - pc,2,1,3,3,8,17,3.823529411764706
earth defense force 2017 - xbox 360,0,2,3,7,5,17,3.8823529411764706
project sylpheed: arc of deception - xbox 360,0,1,3,5,8,17,4.176470588235294
prince of persia: sands of time,0,0,1,4,12,17,4.647058823529412
ori and the blind forest: definitive edition - xbox one,1,0,0,2,14,17,4.647058823529412
super mario world - wii u [digital code],1,0,0,2,14,17,4.647058823529412
resident evil: operation raccoon city special edition -xbox 360,3,4,1,4,5,17,3.235294117647059
call of duty: advanced warfare - pc,4,0,2,4,7,17,3.588235294117647
war of the monsters,0,1,0,6,10,17,4.470588235294118
doom 64,0,0,2,4,11,17,4.529411764705882
just dance 2015 - xbox 360,0,0,1,1,15,17,4.823529411764706
baldur's gate box set (sweden),2,1,1,1,12,17,4.176470588235294
xbox elite wireless controller,1,1,2,2,11,17,4.235294117647059
the hip hop dance experience - xbox 360,1,0,3,7,6,17,4.0
the godfather ii - xbox 360,0,2,5,4,6,17,3.823529411764706
star wars: jedi starfighter,0,1,5,3,8,17,4.0588235294117645
saints row iv: national treasure - playstation 3,1,0,1,4,11,17,4.411764705882353
wii sports club - wii u,0,1,1,2,13,17,4.588235294117647
charizard amiibo - japan import (super smash bros series),0,0,1,2,14,17,4.764705882352941
game party - nintendo wii,1,2,4,5,5,17,3.6470588235294117
lost planet extreme condition: colonies edition -xbox 360,0,0,2,5,10,17,4.470588235294118
zoo tycoon complete collection - pc,0,0,4,4,9,17,4.294117647058823
just dance kids 2 - playstation 3,1,0,3,8,5,17,3.9411764705882355
mass effect 3 digital deluxe version [download],2,1,3,3,8,17,3.823529411764706
medal of honor frontline - xbox,0,0,2,5,10,17,4.470588235294118
midnight club 3 dub edition remix,0,1,1,0,15,17,4.705882352941177
ncaa football 14 - xbox 360,1,1,2,7,6,17,3.9411764705882355
singstar (stand alone) - playstation 3,0,2,1,6,8,17,4.176470588235294
tiger woods pga tour 09 - xbox 360,2,0,2,1,12,17,4.235294117647059
turtle beach - ear force xo four stealth gaming headset - xbox one  (discontinued by manufacturer),1,2,2,4,8,17,3.9411764705882355
wwe smackdown vs. raw 2008 - playstation 2,3,2,4,3,5,17,3.2941176470588234
ps3 500 gb grand theft auto v bundle,2,0,1,0,14,17,4.411764705882353
"persona 4: dancing all night ""disco fever collector's edition""",1,0,1,4,11,17,4.411764705882353
resident evil: revelations 2 - playstation 3,1,0,2,3,11,17,4.352941176470588
brain age: concentration training - nintendo 3ds,2,0,0,3,12,17,4.352941176470588
turtle beach - ear force stealth 420x fully wireless gaming headset - xbox one (discontinued by manufacturer),0,1,0,2,14,17,4.705882352941177
lego indiana jones 2: the adventure continues - xbox 360,0,0,2,4,11,17,4.529411764705882
microsoft xbox one elite,6,1,0,1,9,17,3.3529411764705883
extermination - playstation 2,1,3,2,6,5,17,3.6470588235294117
timeshift - playstation 3,0,2,6,2,7,17,3.823529411764706
shadow hearts: from the new world - playstation 2,0,0,3,5,9,17,4.352941176470588
rayman raving rabbids tv party,1,0,1,7,8,17,4.235294117647059
plantronics gamecom x10 - xbox 360,0,1,3,2,11,17,4.352941176470588
guitar hero iii: legends of rock bundle,0,0,1,7,9,17,4.470588235294118
final fantasy xiii-2 collector's edition - playstation 3,3,0,3,1,10,17,3.8823529411764706
croc: legend of the gobbos,1,1,5,5,5,17,3.7058823529411766
venetica - xbox 360,2,2,2,5,6,17,3.6470588235294117
security bit steel set 3.8mm + 4.5mm security bit screwdriver tool (7cm length) open nes snes n64 super nintendo 64 cartridges & systems,0,0,0,1,16,17,4.9411764705882355
ace combat: assault horizon - playstation 3,1,1,2,2,11,17,4.235294117647059
dirt - xbox 360,1,0,1,4,11,17,4.411764705882353
rule of rose - playstation 2,0,3,3,5,6,17,3.823529411764706
weird park: scary tales [download],0,0,1,8,8,17,4.411764705882353
driv3r - xbox,3,3,1,3,7,17,3.4705882352941178
mount & blade - pc,2,0,3,3,9,17,4.0
xiii - pc,3,1,4,6,3,17,3.2941176470588234
fighters uncaged - xbox 360,1,3,5,2,6,17,3.5294117647058822
putty squad,2,2,3,3,7,17,3.6470588235294117
apollo justice: ace attorney,0,0,0,6,11,17,4.647058823529412
pokepark 2: wonders beyond - wii,0,0,0,3,14,17,4.823529411764706
spy hunter - playstation vita,1,0,1,0,15,17,4.647058823529412
capcom digital collection - xbox 360,0,1,0,6,10,17,4.470588235294118
sonic & sega all-stars racing - xbox 360,0,0,0,4,13,17,4.764705882352941
buffy the vampire slayer,1,0,0,6,10,17,4.411764705882353
dragon age: origins awakening - xbox 360,0,1,2,4,10,17,4.352941176470588
samurai shodown anthology - playstation 2,0,0,2,5,10,17,4.470588235294118
sleeping dogs: definitive edition - xbox one,0,0,1,5,11,17,4.588235294117647
battlefield hardline - xbox 360,2,0,4,3,8,17,3.8823529411764706
sniper elite iii - xbox one standard edition,0,1,3,5,8,17,4.176470588235294
fifa 15 - xbox one,1,0,1,2,13,17,4.529411764705882
friday the 13th,0,2,0,5,10,17,4.352941176470588
just dance 2016 - playstation 4,0,0,4,1,12,17,4.470588235294118
wii lens cleaning kit,2,0,4,2,9,17,3.9411764705882355
ninety-nine nights - xbox 360,1,3,2,7,4,17,3.588235294117647
hotline miami [online game code],0,0,2,3,12,17,4.588235294117647
wipeout pure - sony psp,0,3,0,2,12,17,4.352941176470588
street fighter ii' special champion edition,3,0,1,2,11,17,4.0588235294117645
razer wildcat esports customizable premium controller for xbox one  w/ 4 programmable buttons,0,1,5,1,9,16,4.125
starcraft,1,0,0,1,14,16,4.6875
nintendo selects: donkey kong country returns 3d,0,1,2,4,9,16,4.3125
dualshock 4 wireless controller for playstation 4 - gray blue,0,0,1,0,15,16,4.875
mr. resetti amiibo (animal crossing series),0,0,0,4,12,16,4.75
flash focus:  vision training in minutes a day - nintendo ds,0,1,1,6,8,16,4.3125
wii 2000 points card,1,0,1,4,10,16,4.375
kid icarus,0,0,3,4,9,16,4.375
rabbids: alive & kicking,0,1,4,10,1,16,3.6875
guitar hero 2 - xbox 360,1,1,1,3,10,16,4.25
"teenage mutant ninja turtles iii, the manhattan project",0,0,0,2,14,16,4.875
playstation 3/psp usb 2.0 cable pack (2-pack) (10 foot),2,0,0,4,10,16,4.25
blazing angels: squadrons of wwii - nintendo wii,0,2,4,3,7,16,3.9375
disney infinity 3.0 edition: star wars rise against the empire power disc pack,0,0,0,2,14,16,4.875
bloody roar: primal fury,0,0,1,4,11,16,4.625
the simpsons game,1,1,1,8,5,16,3.9375
the elder scrolls online imperial edition [download],3,1,3,1,8,16,3.625
skylanders spyro's adventure: voodood,0,1,3,1,11,16,4.375
pdp psvita nerf armor - purple,1,1,1,4,9,16,4.1875
sniper: ghost warrior 2,0,0,5,4,7,16,4.125
jade empire special edition,0,0,2,9,5,16,4.1875
disney universe - xbox 360,0,1,4,1,10,16,4.25
thrustmaster t150 rs racing wheel for playstation4/playstation3/pc - playstation 3; playstation 2; playstation,1,0,2,6,7,16,4.125
final fantasy xiv [download],4,3,2,2,5,16,3.0625
marvel vs. capcom: clash of super heroes,0,0,0,3,13,16,4.8125
way of the samurai,2,0,3,1,10,16,4.0625
disney infinity 3.0 edition: star wars chewbacca figure,0,0,0,1,15,16,4.9375
skylanders giants: exclusive golden flameslinger,0,1,1,0,14,16,4.6875
rune factory: a fantasy harvest moon,0,1,2,3,10,16,4.375
the sims vacation expansion pack - pc,0,1,6,3,6,16,3.875
far cry instincts - xbox,0,1,0,7,8,16,4.375
7 wonders of the ancient world - nintendo ds,1,0,1,4,10,16,4.375
dying light: the following - enhanced edition - xbox one,1,0,0,3,12,16,4.5625
kane & lynch: dead men - playstation 3,5,1,3,1,6,16,3.125
tom clancy's ghost recon 2: 2011 final assault,0,0,4,6,6,16,4.125
disgaea 3: absence of detention - playstation vita,1,0,0,2,13,16,4.625
doom: collector's edition - playstation 4,3,0,1,4,8,16,3.875
skylanders spyro's adventure starter pack - playstation 3,0,0,0,5,11,16,4.6875
f.e.a.r. files - xbox 360,1,0,3,4,8,16,4.125
all pro football 2k8 - xbox 360,1,0,7,4,4,16,3.625
far cry compilation,0,1,4,2,9,16,4.1875
fallout 4: contraptions workshop - xbox one digital code,1,1,1,2,11,16,4.3125
teenage mutant ninja turtles: mutants in manhattan - xbox one,2,3,2,4,5,16,3.4375
dragon ball z: the legacy of goku,2,3,2,5,4,16,3.375
xbox 360 250gb holiday value bundle (old model),1,1,2,2,10,16,4.1875
grand theft auto iv special edition - xbox 360,0,0,3,2,11,16,4.5
fire emblem fates: revelation dlc - 3ds [digital code],1,1,2,3,9,16,4.125
turok: evolution,1,2,3,3,7,16,3.8125
psp umd case,0,0,0,5,11,16,4.6875
skylanders superchargers: vehicle sea shadow character pack,0,0,0,1,15,16,4.9375
rome: total war - pc,1,0,1,0,14,16,4.625
half-life: counter-strike - pc,0,2,0,3,11,16,4.4375
lego marvel super heroes - ps vita [digital code],1,0,1,3,11,16,4.4375
assassin's creed unity - xbox one,0,3,1,5,7,16,4.0
blacksite: area 51 - pc,1,4,1,2,8,16,3.75
rocksmith real tone usb audio cable [ubisoft],0,0,2,4,10,16,4.5
ape escape,0,0,1,2,13,16,4.75
rise of nightmares - xbox 360,0,0,3,7,6,16,4.1875
star wars empire at war gold pack,0,1,3,3,9,16,4.25
dark souls ii (black armor edition) - xbox 360 black armor edition,2,0,2,1,11,16,4.1875
the amazing spider-man 2 - playstation 3,0,1,3,3,9,16,4.25
disney infinity 3.0 editon: marvel's hulkbuster figure,0,0,2,0,14,16,4.75
mario & sonic at the olympic games - nintendo ds,0,2,3,4,7,16,4.0
kicks amiibo (animal crossing series),0,0,2,1,13,16,4.6875
blacksite: area 51,2,3,2,4,5,16,3.4375
zumba fitness rush - xbox 360,1,1,0,2,12,16,4.4375
the amazing spider-man 2 - xbox 360,0,3,2,3,8,16,4.0
warioware: twisted!,0,0,0,3,13,16,4.8125
excitebots: trick racing - nintendo wii (game only),0,0,0,5,11,16,4.6875
middle earth: shadow of mordor,2,0,2,6,6,16,3.875
grandia 2,0,0,2,5,9,16,4.4375
fire emblem:  shadow dragon - nintendo ds,1,0,5,4,6,16,3.875
turtle beach call of duty: ghosts ear force phantom limited edition gaming headset - xbox 360,0,2,2,3,9,16,4.1875
mystery case files: return to ravenhearst - pc,0,0,1,4,11,16,4.625
killer instinct gold,0,0,1,3,12,16,4.6875
dragon ball xenoverse - xbox one,1,1,0,1,13,16,4.5
dragon ball xenoverse - playstation 3,1,0,3,0,12,16,4.375
the walking dead: season 2 - playstation 3,0,0,3,0,13,16,4.625
dragon ball z: budokai 2,1,0,3,3,9,16,4.1875
james bond 007 nightfire - xbox,0,1,3,3,9,16,4.25
tetris ds,0,0,0,5,11,16,4.6875
darkwatch - playstation 2,1,0,4,4,7,16,4.0
the sims 2: open for business expansion pack - pc,0,0,2,4,10,16,4.5
shenmue ii,0,0,0,3,13,16,4.8125
command and conquer the first decade,2,0,2,3,9,16,4.0625
ganondorf amiibo - japan import (super smash bros series),0,0,0,1,15,16,4.9375
panzer dragoon orta,1,1,2,6,6,16,3.9375
toy story 3 the video game - nintendo ds,0,2,2,5,7,16,4.0625
rumble roses xx - xbox 360,2,3,2,5,4,16,3.375
the sims 2: ikea home stuff - pc,0,2,3,4,7,16,4.0
playstation 2 power cord (bulk packaging),0,0,1,1,14,16,4.8125
fifa 14 - xbox one,0,2,2,3,9,16,4.1875
madden nfl 2002,0,0,3,6,7,16,4.25
disney infinity: marvel super heroes (2.0 edition) video game starter pack - playstation 3,0,1,1,4,10,16,4.4375
limited edition vertical stand for glacier white playstation 4,0,0,1,2,13,16,4.75
just dance 2016 - wii,1,0,0,3,12,16,4.5625
advance wars: days of ruin,0,0,0,4,12,16,4.75
oni,3,2,2,6,3,16,3.25
samurai warriors 4 - playstation 4,1,1,0,3,11,16,4.375
ace combat assault horizon - xbox 360,2,2,4,3,5,16,3.4375
deus ex human revolution: director's cut - xbox 360,1,2,1,4,8,16,4.0
leegoal high quality premium super grip glow black green white silicon protective skin case cover for sony playstation ps3 remote controller,0,0,1,4,11,16,4.625
deus ex human revolution: director's cut - playstation 3,1,0,2,4,9,16,4.25
full auto - xbox 360,0,1,3,10,2,16,3.8125
cabela's dangerous hunts 2013 with gun - xbox 360,2,2,4,4,4,16,3.375
batman: return to arkham - xbox one,1,1,4,2,8,16,3.9375
shape up - xbox one,1,0,5,2,8,16,4.0
disney's aladdin,0,0,0,4,12,16,4.75
project spark,2,3,0,3,8,16,3.75
nintendo callie & marie 2-pack amiibo - nintendo wii u,0,0,1,2,13,16,4.75
super mario bros. 3  - wii u [digital code],0,0,2,4,10,16,4.5
style savvy: trendsetters - nintendo 3ds,0,1,0,2,13,16,4.6875
the sims bustin' out,3,0,2,5,6,16,3.6875
tom clancy's splinter cell - pc,2,0,3,5,6,16,3.8125
mario super sluggers,0,0,0,7,9,16,4.5625
assassin’s creed syndicate - gold edition - xbox one,1,0,1,2,12,16,4.5
ridge racer - sony psp,0,0,3,1,12,16,4.5625
polk audio striker zx xbox one gaming headset - blue,0,2,1,10,3,16,3.875
operation flashpoint: dragon rising - playstation 3,1,4,2,3,6,16,3.5625
madden nfl 25 anniversary edition with nfl sunday ticket - playstation 3,3,0,3,5,5,16,3.5625
assassin's creed: bloodlines - sony psp,1,1,4,4,6,16,3.8125
sc-1 wireless sports controller for playstation 3,0,0,3,7,6,16,4.1875
operation flashpoint: dragon rising,3,3,4,3,3,16,3.0
evil dead regeneration - playstation 2,1,2,1,4,8,16,4.0
rise to honor - playstation 2,0,4,4,6,2,16,3.375
the smurfs 2 - nintendo wii u,1,2,7,2,4,16,3.375
lego: marvel - playstation vita,1,0,1,3,11,16,4.4375
sid meier's pirates! - pc,0,2,1,7,6,16,4.0625
gran turismo 2,0,0,2,4,10,16,4.5
lego: marvel super heroes - nintendo 3ds,1,1,1,1,12,16,4.375
dmc devil may cry: definitive edition - xbox one,0,0,0,3,13,16,4.8125
mafia ii - pc,1,1,5,5,4,16,3.625
"insten clip on crystal case compatible with sony psp 3000, clear",2,0,0,5,9,16,4.1875
gun - gamecube,0,0,3,3,10,16,4.4375
need for speed: nitro,1,1,3,6,5,16,3.8125
mlb 09 the show - playstation 3,1,1,3,1,10,16,4.125
fire emblem: path of radiance - gamecube,1,0,0,3,12,16,4.5625
game & wario - nintendo wii u,2,2,2,5,5,16,3.5625
world of warcraft: warlords of draenor collector's edition - pc/mac,0,1,1,1,13,16,4.625
might & magic: clash of heroes - nintendo ds,0,1,1,5,9,16,4.375
mega man x7,5,5,3,0,3,16,2.4375
call of duty: world at war - nintendo wii,0,0,4,6,6,16,4.125
monopoly family fun pack - playstation 4 standard edition,0,1,3,6,6,16,4.0625
squidgrip for xbox 360 controller (controller not included),1,2,2,3,8,16,3.9375
battlefield 1942: the complete collection - pc,1,1,1,8,5,16,3.9375
the matrix: path of neo - playstation 2,0,2,2,5,7,16,4.0625
dead to rights - playstation 2,1,0,3,5,7,16,4.0625
disney's aladdin,0,0,2,4,10,16,4.5
playstation 4 500gb console - batman arkham knight bundle limited edition[discontinued],2,0,0,1,13,16,4.4375
sega genesis game controller model #1650,1,0,2,1,12,16,4.4375
xbox 360 vga hd av cable,0,0,0,1,15,16,4.9375
star ocean: second evolution - sony psp,0,1,0,3,12,16,4.625
marvel nemesis: rise of the imperfects - playstation 2,2,2,1,1,10,16,3.9375
little king's story - nintendo wii,1,0,0,5,10,16,4.4375
picross 3d - nintendo ds,1,0,1,3,11,16,4.4375
call of duty: black ops combo pack - xbox 360,4,1,0,0,11,16,3.8125
deus ex: invisible war,0,2,2,4,8,16,4.125
castlevania judgment,0,2,5,3,6,16,3.8125
fifa 15 - xbox 360,0,0,0,1,15,16,4.9375
playstation 3 ex-02 next gen bluetooth headset with faceplates,0,1,3,9,3,16,3.875
dragon quest heroes: rocket slime - nintendo ds,0,1,2,4,9,16,4.3125
def jam fight for ny,0,1,0,2,13,16,4.6875
".hack, part 2: mutation",1,0,2,0,13,16,4.5
pokemon mystery dungeon: blue rescue team,0,2,0,4,10,16,4.375
world of final fantasy - playstation 4,1,0,3,4,8,16,4.125
the legend of heroes: trails in the sky - sony psp,1,0,0,3,12,16,4.5625
midnight club: street racing - playstation 2,0,2,3,5,6,16,3.9375
007 the world is not enough,0,1,1,8,6,16,4.1875
batman vengeance,0,0,6,7,3,16,3.8125
"monoprice 6ft 4 in 1 component cable for xbox 360, wii, ps3 and ps2",1,2,0,1,12,16,4.3125
area 51 - playstation 2,0,0,3,5,8,16,4.3125
fight night champion - xbox 360,1,3,4,5,3,16,3.375
super monkey ball: banana blitz,1,2,2,8,3,16,3.625
city of heroes - pc,0,0,3,6,7,16,4.25
dr. mario amiibo - japan import (super smash bros series),0,0,0,0,16,16,5.0
the sims 3: katy perry sweet treats,0,0,2,2,12,16,4.625
the legend of heroes: trails of cold steel ii - playstation vita,0,0,0,2,14,16,4.875
nintendo 3ds pull and go folio - blue,0,1,0,2,13,16,4.6875
call of duty 3 - nintendo wii,0,2,0,9,5,16,4.0625
lego star wars ii: the original trilogy - xbox 360,0,0,2,3,11,16,4.5625
star wars: starfighter,0,0,4,3,9,16,4.3125
f.e.a.r. extraction point - pc,2,1,3,4,6,16,3.6875
the incredible hulk: ultimate destruction - playstation 2,0,1,0,7,8,16,4.375
disney infinity elsa,0,0,1,1,14,16,4.8125
trackmania turbo - xbox one,0,0,1,2,13,16,4.75
disney infinity 3.0 edition: star wars saga bundle - ps4,1,1,2,1,11,16,4.25
twisted metal,0,1,0,1,14,16,4.75
grid autosport - playstation 3 black edition,0,1,3,3,9,16,4.25
mario party 6,0,0,2,8,6,16,4.25
aceshot thumb grips (8pc) for xbox one (one s & x) by foamy lizard ® sweat free 100% silicone precision raised antislip rubber analog stick grips for xbox one controller (8 grips) black,1,1,2,2,10,16,4.1875
xbox 360 av cable,2,0,0,4,10,16,4.25
playstation 2 memory card 16mb,0,0,0,4,12,16,4.75
south park: the fractured but whole - xbox one,0,0,1,7,8,16,4.4375
mario party,1,1,0,6,8,16,4.1875
star ocean: the second story,0,0,2,7,6,15,4.266666666666667
conflict: denied ops - pc,1,2,5,3,4,15,3.466666666666667
spider-man - xbox,0,0,1,6,8,15,4.466666666666667
fire pro wrestling returns - playstation 2,1,3,2,3,6,15,3.6666666666666665
rocket league - ps4 [digital code],0,0,0,1,14,15,4.933333333333334
lego the hobbit - playstation 3,0,0,2,3,10,15,4.533333333333333
baldur's gate: dark alliance,0,0,2,7,6,15,4.266666666666667
"mortal kombat kollection (deception, armageddon, shaolin monks) - playstation 2",1,0,1,2,11,15,4.466666666666667
fox amiibo - japan import (super smash bros series),0,0,0,1,14,15,4.933333333333334
call of juarez: bound in blood - pc,1,1,2,6,5,15,3.8666666666666667
necrovision - pc,1,4,1,4,5,15,3.533333333333333
tron 2.0 - pc,0,0,0,6,9,15,4.6
snoopy's grand adventure - wii u,0,0,3,6,6,15,4.2
call of duty: black ops combo pack - playstation 3,0,0,2,1,12,15,4.666666666666667
the sims 3: pets - xbox 360,2,1,0,3,9,15,4.066666666666666
two worlds: epic edition - pc,1,1,2,6,5,15,3.8666666666666667
pdp super mario pipe amiibo figure stand,1,0,0,5,9,15,4.4
disney infinity 3.0 edition starter pack - xbox 360,2,1,1,3,8,15,3.933333333333333
carnival games: minigolf - nintendo wii,2,2,4,3,4,15,3.3333333333333335
megadimension neptunia vii - playstation 4,0,1,2,2,10,15,4.4
operation flashpoint: red river - xbox 360,1,1,4,4,5,15,3.7333333333333334
suikoden,0,1,0,2,12,15,4.666666666666667
"turtle beach - ear force elite 800x premium fully wireless gaming headset - dts headphone:x 7.1 surround sound - noise cancellation- xbox one, mobile devices",1,2,3,3,6,15,3.7333333333333334
conflict: denied ops - playstation 3,3,6,0,2,4,15,2.8666666666666667
pikmin & olimar amiibo - japan import (super smash bros series),0,0,0,2,13,15,4.866666666666666
wappy dog for nintendo ds,0,1,3,8,3,15,3.8666666666666667
the elder scrolls iv: shivering isles - xbox 360,0,1,0,10,4,15,4.133333333333334
lord of the rings the two towers - gamecube,0,0,5,5,5,15,4.0
nancy drew: the white wolf of icicle creek - pc,0,0,2,8,5,15,4.2
lego dimensions starter pack - playstation 4,0,1,0,4,10,15,4.533333333333333
avatar - playstation 3,0,0,1,4,10,15,4.6
tetris,0,0,1,0,14,15,4.866666666666666
gameshark pro,1,0,2,4,8,15,4.2
suikoden: tierkreis - nintendo ds,0,0,4,6,5,15,4.066666666666666
the chronicles of riddick: assault on dark athena - xbox 360,0,2,3,4,6,15,3.933333333333333
tomb raider: definitive edition (art book packaging) - xbox one,2,1,0,5,7,15,3.933333333333333
supreme commander 2 - pc,0,3,6,2,4,15,3.466666666666667
hunted: the demon's forge,2,2,3,2,6,15,3.533333333333333
silent hill 2 - pc,0,0,0,3,12,15,4.8
birds of steel - xbox 360,0,0,5,3,7,15,4.133333333333334
starwars:battlefront,0,0,0,3,12,15,4.8
".hack, part 4: quarantine",3,2,1,2,7,15,3.533333333333333
generic battery pack cover for xbox 360 controller,0,0,2,0,13,15,4.733333333333333
thor: god of thunder - playstation 3,3,2,1,4,5,15,3.4
kirby's dream land,0,0,1,4,10,15,4.6
madden nfl 2005 - xbox,1,1,1,8,4,15,3.8666666666666667
battlefield 1942: world war ii anthology - pc,0,2,1,1,11,15,4.4
demon stone - playstation 2,0,1,3,5,6,15,4.066666666666666
sega bass fishing - nintendo wii,0,2,4,8,1,15,3.533333333333333
final fantasy xiv online: 60 day time card [online game code],0,0,0,0,15,15,5.0
ps vita 2000 silicone skin,1,0,3,2,9,15,4.2
donkey kong - classic nes series,1,0,2,4,8,15,4.2
viewtiful joe - gamecube,0,1,0,2,12,15,4.666666666666667
sonic rush adventure,0,0,2,4,9,15,4.466666666666667
playstation 4 500gb console - uncharted: the nathan drake collection bundle (physical disc)[discontinued],1,0,0,2,12,15,4.6
nintendo nes controller,2,0,2,1,10,15,4.133333333333334
wwe smackdown vs. raw 2010 - xbox 360,3,0,3,3,6,15,3.6
insten replacement controller adapter compatible with ps2 to ps3 playstation controller adapter usb converter,2,0,2,3,8,15,4.0
suikoden iv - playstation 2,3,2,3,3,4,15,3.2
donkey kong amiibo - japan import (super smash bros series),1,0,0,0,14,15,4.733333333333333
pythons vertical stand for ps4 console-black,0,1,1,1,12,15,4.6
tomb raider anniversary,0,0,1,7,7,15,4.4
infamous 2 hero edition - playstation 3,0,0,0,4,11,15,4.733333333333333
grand theft auto 2,2,0,2,5,6,15,3.8666666666666667
the lord of the rings: conquest - xbox 360,3,0,5,2,5,15,3.4
tom clancy's splinter cell chaos theory - playstation 2,0,0,2,3,10,15,4.533333333333333
silent hill: shattered memories - playstation 2,0,0,3,7,5,15,4.133333333333334
pokemon ranger: shadows of almia,0,0,0,1,14,15,4.933333333333334
dance dance revolution ddr max - playstation 2,0,1,2,5,7,15,4.2
turtle beach - ear force chat cable for playstation 4 headset compatibility - ps4,1,0,2,2,10,15,4.333333333333333
the lord of the rings: the fellowship of the ring - pc,5,4,2,2,2,15,2.466666666666667
"catherine ""love is over"" deluxe edition, playstation 3",0,0,1,3,11,15,4.666666666666667
rock band 4 band-in-a-box bundle - xbox one,4,3,1,6,1,15,2.8
mario & sonic at the london 2012 olympic games,1,0,1,2,11,15,4.466666666666667
harvest moon: tale of two towns - nintendo 3ds,3,1,2,1,8,15,3.6666666666666665
sony playstation 2 dualshock 2 analog wired controller scph-10010 - ocean blue,1,1,0,2,11,15,4.4
james bond 007: blood stone - playstation 3,0,0,1,8,6,15,4.333333333333333
mario party 2,0,2,0,4,9,15,4.333333333333333
warhammer online: age of reckoning - pc,2,5,0,1,7,15,3.4
true crime: streets of la - xbox,1,1,5,5,3,15,3.533333333333333
iron man - xbox 360,2,2,4,5,2,15,3.2
disney infinity: marvel super heroes (2.0 edition) video game starter pack - xbox 360,1,0,4,1,9,15,4.133333333333334
neverwinter nights 2 gold - pc,0,6,0,7,2,15,3.3333333333333335
counter-strike - xbox,1,1,3,3,7,15,3.933333333333333
vga s-video adapter [retrobit],2,1,0,2,10,15,4.133333333333334
the lion king,0,0,2,0,13,15,4.733333333333333
ea access 12 month subscription - xbox one [digital code],1,1,1,1,11,15,4.333333333333333
marvel vs. capcom 3: fate of two worlds: special edition - playstation 3,0,1,1,3,10,15,4.466666666666667
gun valkyrie,0,2,2,3,8,15,4.133333333333334
chip 'n dale: rescue rangers,0,0,1,4,10,15,4.6
nyko charge station quad for wii (black),0,0,2,3,10,15,4.533333333333333
dragon age origins: ultimate edition [download],3,0,2,1,9,15,3.8666666666666667
lego batman 3: beyond gotham - xbox one,1,0,2,2,10,15,4.333333333333333
earth defense force: insect armageddon - xbox 360,0,2,1,7,5,15,4.0
nintendo wii intec g5614 dual charge station and turbo cooler,0,0,2,2,11,15,4.6
transformers devastation - xbox one,1,0,2,2,10,15,4.333333333333333
battlefield hardline - playstation 3,1,1,3,3,7,15,3.933333333333333
shin megami tensei: devil survivor 2 record breaker - nintendo 3ds,0,2,0,3,10,15,4.4
rise of the tomb raider [online game code],1,0,1,3,10,15,4.4
michael jackson the experience - playstation 3,0,0,0,3,12,15,4.8
tna impact,0,0,3,5,7,15,4.266666666666667
pharaoh - pc,1,0,2,3,9,15,4.266666666666667
nintendo 64 system video game console jungle green,0,0,0,3,12,15,4.8
need for speed: most wanted,0,6,4,3,2,15,3.066666666666667
baroque - playstation 2,2,5,3,2,3,15,2.933333333333333
syphon filter 2,0,0,0,4,11,15,4.733333333333333
overclocked - pc,0,2,5,2,6,15,3.8
dragonball z: burst limit - playstation 3,2,0,4,2,7,15,3.8
pokemon rumble blast,2,0,3,2,8,15,3.933333333333333
lords of the fallen - playstation 4,1,2,2,5,5,15,3.7333333333333334
space invaders extreme - nintendo ds,0,0,0,8,7,15,4.466666666666667
brothers - playstation 4,1,0,1,2,11,15,4.466666666666667
samurai warriors chronicles - nintendo 3ds,0,1,0,3,11,15,4.6
skylanders superchargers dual pack #2: hurricane jet-vac and jet stream,1,0,0,1,13,15,4.666666666666667
nba 2k16 - xbox one,1,1,2,3,8,15,4.066666666666666
warhammer dawn of war ii - pc,3,1,2,4,5,15,3.466666666666667
nhl 16 - playstation 4,0,2,1,4,8,15,4.2
wwe 2k16 - playstation 3,2,1,0,1,11,15,4.2
manhunt,0,1,1,5,8,15,4.333333333333333
guitar hero world tour - playstation 3 (game only),0,0,4,3,8,15,4.266666666666667
sword art online: lost song - playstation 4,0,1,4,1,9,15,4.2
xbox 360 intercooler 360 - black,1,2,2,1,9,15,4.0
ghostbusters: the video game - pc,7,0,0,4,4,15,2.8666666666666667
ps3 move charge station quad port charging dock,1,0,0,3,11,15,4.533333333333333
disney princess: magical jewels - nintendo ds,1,1,0,1,12,15,4.466666666666667
skylanders spyro's adventure starter pack - xbox 360,0,0,2,3,10,15,4.533333333333333
lego harry potter: years 5-7 - nintendo wii,0,0,0,5,10,15,4.666666666666667
"turtle beach - ear force elite 800 - premium fully wireless gaming headset - dts headphone:x 7.1 surround sound - noise cancellation - superhuman hearing - ps4, ps3, and mobile devices",3,2,4,3,3,15,3.066666666666667
brothers in arms: road to hill 30,0,1,3,4,7,15,4.133333333333334
mega man 8,0,1,2,5,7,15,4.2
spore galactic edition - pc/mac,12,0,2,0,1,15,1.5333333333333334
fable with bonus dvd,0,1,3,5,6,15,4.066666666666666
naruto ultimate ninja: storm,0,0,2,1,12,15,4.666666666666667
spider-man: shattered dimensions - xbox 360,0,3,1,3,8,15,4.066666666666666
50 cent: blood on the sand,0,0,0,10,5,15,4.333333333333333
dynasty warriors 6 - xbox 360,0,0,4,4,7,15,4.2
duck tales,0,0,0,7,8,15,4.533333333333333
iron man - nintendo wii,1,4,3,3,4,15,3.3333333333333335
godzilla: destroy all monsters melee,0,0,1,3,11,15,4.666666666666667
spider-man 2,0,2,1,3,9,15,4.266666666666667
beyond good and evil,0,0,0,6,9,15,4.6
burnout 2: point of impact - playstation2,0,0,1,2,12,15,4.733333333333333
hulk,0,2,2,6,5,15,3.933333333333333
prince of persia: warrior within,1,1,3,7,3,15,3.6666666666666665
dracula origin - pc,0,0,1,6,8,15,4.466666666666667
lost planet extreme condition: colonies edition - pc,5,0,1,4,5,15,3.2666666666666666
guitar hero: warriors of rock stand-alone software - playstation 3,0,0,2,3,10,15,4.533333333333333
mad catz xbox 360 ax pro dolby digital precision version 1.0 gaming headset,0,2,4,4,5,15,3.8
nba jam - nintendo wii,1,0,0,6,8,15,4.333333333333333
kane & lynch: dead men - xbox 360,2,2,5,3,3,15,3.2
dementium: the ward - nintendo ds,0,2,4,5,4,15,3.7333333333333334
the first templar - xbox 360,2,0,5,3,5,15,3.6
spyro: enter the dragonfly,2,3,1,3,6,15,3.533333333333333
turtle beach - ear force headset audio controller plus - superhuman hearing - xbox one,1,1,1,4,8,15,4.133333333333334
the sims 2: teen style stuff - pc,0,0,1,3,11,15,4.666666666666667
jurassic park - the game - xbox 360,1,3,5,3,3,15,3.2666666666666666
nintendo waluigi amiibo (sm series) - nintendo wii u,0,0,0,1,14,15,4.933333333333334
the smurfs 2 - xbox 360,1,2,5,2,5,15,3.533333333333333
xcom 2 - playstation 4,0,0,3,5,7,15,4.266666666666667
wii black console with new super mario brothers wii and music cd,5,0,3,1,6,15,3.2
just cause - xbox 360,0,1,7,3,4,15,3.6666666666666665
teenage mutant ninja turtles,1,0,4,5,5,15,3.8666666666666667
killer is dead - xbox 360,0,1,0,5,9,15,4.466666666666667
prince of persia the two thrones - gamecube,0,0,2,3,10,15,4.533333333333333
bayonetta 2 (single disc) - wii u,1,0,1,2,11,15,4.466666666666667
aliens colonial marines collector's edition -xbox 360,0,5,2,1,7,15,3.6666666666666665
earth defense force 2025 - xbox 360,1,0,1,4,9,15,4.333333333333333
shin megami tensei digital devil saga 2 - playstation 2,0,1,0,3,11,15,4.6
sonic the hedgehog 3,0,0,2,2,11,15,4.6
crash bash - playstation,1,0,1,2,11,15,4.466666666666667
sega genesis collection - sony psp,0,0,2,3,10,15,4.533333333333333
midnight club 2,0,1,1,4,9,15,4.4
mario superstar baseball - gamecube,0,1,1,6,7,15,4.266666666666667
wario land 4,0,0,0,2,13,15,4.866666666666666
xenosaga episode iii - playstation 2,0,0,1,1,13,15,4.8
call of duty 2 big red one - xbox,0,0,4,2,9,15,4.333333333333333
call of duty 2: big red one - playstation 2,0,0,3,4,8,15,4.333333333333333
skylanders swap force starter pack - xbox 360,0,1,2,3,9,15,4.333333333333333
brothers in arms: hell's highway - pc,0,1,0,6,8,15,4.4
red faction - pc,0,1,5,8,1,15,3.6
turtle beach ear force xp seven mlg pro circuit programmable surround sound console headset,0,1,2,5,7,15,4.2
shin megami tensei: persona 3 - playstation 2,2,0,0,5,8,15,4.133333333333334
god hand - playstation 2,0,0,0,3,12,15,4.8
mega man x5,2,1,5,2,5,15,3.466666666666667
yakuza - playstation 2,0,0,2,5,8,15,4.4
lego star wars: force awakens deluxe edition - playstation 4,0,0,2,2,11,15,4.6
rock candy blueberry boom,2,1,0,2,10,15,4.133333333333334
fire emblem: the sacred stones,0,0,1,2,12,15,4.733333333333333
dynasty warriors 2,0,0,5,6,4,15,3.933333333333333
lego harry potter: years 5-7 - playstation vita,0,0,3,2,10,15,4.466666666666667
the legend of zelda: majora's mask - collector's edition,0,0,2,1,12,15,4.666666666666667
chromehounds - xbox 360,1,1,5,3,5,15,3.6666666666666665
the warriors,1,0,2,2,10,15,4.333333333333333
eagle flight - playstation vr,1,0,0,5,9,15,4.4
gran turismo sport - playstation 4,5,2,5,2,1,15,2.466666666666667
mlb 2k13 - xbox 360,2,0,0,6,7,15,4.066666666666666
tekken 2,0,0,1,2,12,15,4.733333333333333
fifa 14 - xbox 360,4,0,1,3,7,15,3.6
yaiba: ninja gaiden z,1,2,2,4,6,15,3.8
medal of honor european assault - playstation 2,1,2,2,2,8,15,3.933333333333333
brothers in arms: hell's highway - playstation 3,2,1,1,3,8,15,3.933333333333333
oddworld stranger's wrath,0,0,1,2,12,15,4.733333333333333
ragnarok odyssey ace - playstation 3,0,1,0,4,10,15,4.533333333333333
call of duty 3 - playstation 2,1,0,1,3,10,15,4.4
nintendo diddy kong amiibo (sm series) - nintendo wii u,0,0,0,0,15,15,5.0
prey - pc,1,5,1,3,5,15,3.4
puzzle quest: challenge of the warlords - sony psp,3,0,3,1,8,15,3.7333333333333334
nintendo ds wi-fi usb connector,1,3,2,3,6,15,3.6666666666666665
xbox 360 wireless controller - gold chrome,0,0,1,2,12,15,4.733333333333333
skylanders adventure case,0,0,0,2,13,15,4.866666666666666
mega man maverick hunter x - sony psp,0,0,1,3,11,15,4.666666666666667
jak x combat racing - playstation 2,2,0,1,6,6,15,3.933333333333333
trauma center: second opinion - nintendo wii,0,0,3,7,5,15,4.133333333333334
the sims 3 diesel stuff pack [instant access],0,1,3,1,10,15,4.333333333333333
duke nukem 64,0,0,1,4,10,15,4.6
ggg0030 video game cartridge dust cover 6 pack: for nintendo 64 games (n64 cart protector sleeve cover or case),0,0,1,0,14,15,4.866666666666666
visual memory unit - white,0,0,3,2,10,15,4.466666666666667
mega man legacy collection - collectors edition - nintendo 3ds,0,0,1,2,12,15,4.733333333333333
nba live 14 - xbox one,4,2,1,2,6,15,3.2666666666666666
saints row iv pc,2,0,3,5,5,15,3.7333333333333334
xcom: enemy within,0,1,0,1,13,15,4.733333333333333
gen 2 x extension cable for super nintendo snes controller,0,0,1,2,12,15,4.733333333333333
nintendo daisy amiibo (sm series) - nintendo wii u,1,0,1,1,12,15,4.533333333333333
capcom vs snk 2,1,0,1,7,6,15,4.133333333333334
skylanders spyro's adventure: lightning rod,0,0,2,0,13,15,4.733333333333333
sid meier's civilization v: gods and kings - pc,0,0,3,5,7,15,4.266666666666667
saints row: the third- the full package - xbox 360,1,0,1,1,12,15,4.533333333333333
medal of honor underground,2,0,1,1,11,15,4.266666666666667
1080 snowboarding,1,0,2,3,8,14,4.214285714285714
mysims kingdom - nintendo ds,1,1,1,4,7,14,4.071428571428571
sega game gear handheld video game console,1,2,0,4,7,14,4.0
dark souls: prepare to die edition [online game code],1,2,1,3,7,14,3.9285714285714284
zettaguard classic controller for nintendo wii,1,0,0,2,11,14,4.571428571428571
official nintendo travel case for dsi and dsi xl - wine,0,0,0,1,13,14,4.928571428571429
tom clancy's ghost recon - pc,1,0,2,6,5,14,4.0
halo 3 legendary edition -xbox 360,1,0,0,2,11,14,4.571428571428571
double dragon ii: the revenge,0,0,1,3,10,14,4.642857142857143
turtle beach ear force nla gaming headset - black - nintendo wii u,1,1,2,0,10,14,4.214285714285714
blazing angels squadrons of wwii - xbox 360,2,3,4,1,4,14,3.142857142857143
saints row iv: national treasure - xbox 360,0,0,0,6,8,14,4.571428571428571
rallisport challenge,0,1,1,3,9,14,4.428571428571429
atv offroad fury 2 - playstation 2,0,0,1,3,10,14,4.642857142857143
wii guitar hero world tour band kit,1,0,1,2,10,14,4.428571428571429
nintendo 64 transfer pak,0,2,4,1,7,14,3.9285714285714284
diddy kong racing ds,1,1,5,5,2,14,3.4285714285714284
f-zero x,0,1,1,4,8,14,4.357142857142857
champions of norrath - playstation 2,0,1,1,4,8,14,4.357142857142857
x-files: resist or serve - playstation 2,1,1,1,6,5,14,3.9285714285714284
destiny - expansion pass - playstation 4 [digital code],2,0,1,2,9,14,4.142857142857143
shantae: half-genie hero - risky beats edition - playstation 4,0,0,1,4,9,14,4.571428571428571
disney fantasia: music evolved - xbox one,0,0,1,2,11,14,4.714285714285714
rock band 4 band-in-a-box bundle - playstation 4,1,2,4,2,5,14,3.5714285714285716
sony ps4 500gb console the last of us remastered,3,1,1,1,8,14,3.7142857142857144
banjo-kazooie: nuts & bolts - xbox 360,2,1,3,1,7,14,3.7142857142857144
pac man world 2 - playstation 2,0,0,1,6,7,14,4.428571428571429
syndicate,1,4,2,0,7,14,3.5714285714285716
nhl 16 - xbox one,0,1,1,5,7,14,4.285714285714286
final fantasy fables: chocobo's dungeon - nintendo wii,0,2,4,0,8,14,4.0
ultimate band - nintendo wii,0,4,2,4,4,14,3.5714285714285716
titanfall 2 - pc,1,1,4,1,7,14,3.857142857142857
sonic riders - gamecube,0,1,1,3,9,14,4.428571428571429
wcw/nwo revenge,0,0,1,4,9,14,4.571428571428571
crazy taxi 3 - xbox,0,0,3,4,7,14,4.285714285714286
playstation vita carrying case,2,0,4,3,5,14,3.642857142857143
lords of the fallen - xbox one : limited edition,1,2,4,5,2,14,3.357142857142857
wii u gamepad stand/cradle set - black,0,0,2,2,10,14,4.571428571428571
need for speed carbon - nintendo wii,0,0,1,8,5,14,4.285714285714286
nintendo - wuparswa - wii u pro controller - white,1,0,0,2,11,14,4.571428571428571
medal of honor warfighter - pc,1,3,0,5,5,14,3.7142857142857144
just dance 2014 - playstation 4,0,0,1,2,11,14,4.714285714285714
legacy of kain: defiance,0,1,3,3,7,14,4.142857142857143
the king of fighters xiv: burn to fight premium edition - playstation 4,1,0,0,2,11,14,4.571428571428571
hasbro family fun pack - playstation 4 standard edition,0,2,2,4,6,14,4.0
soldier of fortune: payback,3,1,5,2,3,14,3.0714285714285716
atari flashback classics: volume 1,4,1,1,5,3,14,3.142857142857143
angry birds: star wars - playstation 4,3,3,1,1,6,14,3.2857142857142856
pdp ag7 true wireless headset for xbox one,0,1,3,6,4,14,3.9285714285714284
gauntlet: dark legacy,1,1,2,2,8,14,4.071428571428571
lord of the rings: fellowship of the ring - playstation 2,2,1,2,4,5,14,3.642857142857143
nyko power kit plus - 2 pack rechargeable battery with charge cable for xbox 360,0,1,2,2,9,14,4.357142857142857
donkey konga (includes bongos),0,0,5,4,5,14,4.0
sid meier's pirates - sony psp,0,3,1,2,8,14,4.071428571428571
sniper ghost warrior [download],1,1,3,3,6,14,3.857142857142857
helldivers super earth edition - playstation 4,1,1,1,2,9,14,4.214285714285714
angry birds star wars - playstation 3,3,0,1,2,8,14,3.857142857142857
mega man 4,0,0,2,4,8,14,4.428571428571429
psp av cable,1,0,0,3,10,14,4.5
"insten snap-on crystal case compatible with sony playstation vita, clear",1,3,3,2,5,14,3.5
lego batman 2: dc super heroes - nintendo 3ds,0,0,1,3,10,14,4.642857142857143
star wars: bounty hunter,1,1,5,2,5,14,3.642857142857143
nba 2k15 - xbox 360,1,0,2,1,10,14,4.357142857142857
mega man 6,0,0,2,5,7,14,4.357142857142857
the walking dead: the complete first season - xbox one,0,1,3,0,10,14,4.357142857142857
suikoden ii,0,0,0,2,12,14,4.857142857142857
skylanders spyro's adventure: zook,0,0,1,1,12,14,4.785714285714286
call of duty advanced warfare - day zero edition,2,1,2,3,6,14,3.7142857142857144
nintendo ds lite dura-case - white,0,1,1,4,8,14,4.357142857142857
indigo prophecy - xbox,0,0,2,5,7,14,4.357142857142857
atelier meruru: the apprentice of arland - playstation 3,1,0,1,2,10,14,4.428571428571429
bluecell clear & gray game/memory card protection hard case for sony ps playstation vita,0,0,2,2,10,14,4.571428571428571
spirit camera: the cursed memoir - nintendo 3ds,1,1,2,5,5,14,3.857142857142857
tales from the borderlands - playstation 4,1,0,0,2,11,14,4.571428571428571
mario vs. donkey kong,1,0,0,5,8,14,4.357142857142857
the sims 4 premium edition,3,1,5,1,4,14,3.142857142857143
rfactor v. 1.255 - pc,0,0,2,2,10,14,4.571428571428571
combat flight simulator 3: battle for europe - pc,0,0,4,4,6,14,4.142857142857143
myst uru: complete chronicles - pc,0,0,3,3,8,14,4.357142857142857
animal crossing: happy home designer bundle - nintendo 3ds,0,2,0,1,11,14,4.5
xbox 360 arcade [old version],2,1,5,2,4,14,3.357142857142857
"nintendo animal crossing amiibo cards series 4 for nintendo wii u, 1-pack (6 cards/pack)",0,0,0,3,11,14,4.785714285714286
rock band - playstation 2 (game only),0,0,0,4,10,14,4.714285714285714
playstation 2 rock band special edition,0,0,4,0,10,14,4.428571428571429
unreal tournament iii - pc,0,1,2,3,8,14,4.285714285714286
$20 battle.net store gift card balance - blizzard entertainment [digital code] [online game code],0,0,0,0,14,14,5.0
myst iv: revelation (dvd-rom) - pc/mac,0,1,1,5,7,14,4.285714285714286
dragon age inquisition - deluxe edition - pc,1,2,1,4,6,14,3.857142857142857
def jam fight for new york,0,1,1,6,6,14,4.214285714285714
unreal tournament - pc,0,0,0,2,12,14,4.857142857142857
star wars - episode i - racer,0,0,1,4,9,14,4.571428571428571
f.e.a.r. platinum collection: the complete trilogy - pc,0,0,2,5,7,14,4.357142857142857
anarchy reigns - playstation 3,1,1,2,1,9,14,4.142857142857143
captain america: super soldier - xbox 360,0,1,4,6,3,14,3.7857142857142856
anarchy reigns - xbox 360,4,1,1,5,3,14,3.142857142857143
kirby's adventure,0,0,0,0,14,14,5.0
tom clancy's endwar,0,2,4,2,6,14,3.857142857142857
ghostbusters - nintendo ds,0,2,4,2,6,14,3.857142857142857
socom u.s. navy seals: combined assault - playstation 2,1,0,1,6,6,14,4.142857142857143
sony playstation memory card (white),1,1,1,3,8,14,4.142857142857143
skylanders superchargers: drivers splat character pack,0,0,0,0,14,14,5.0
metal gear acid,0,3,2,6,3,14,3.642857142857143
destiny: the taken king - legendary edition - xbox 360,0,0,4,2,8,14,4.285714285714286
wwf smackdown!,2,2,2,0,8,14,3.7142857142857144
psp pouch and wrist strap,0,1,1,3,9,14,4.428571428571429
medal of honor,0,0,1,2,11,14,4.714285714285714
playstation 4 500gb console - uncharted 4 limited edition bundle [discontinued],2,0,0,1,11,14,4.357142857142857
time splitters: future perfect - playstation 2,1,0,1,4,8,14,4.285714285714286
assassins creed syndicate - gold edition - playstation 4,0,1,0,4,9,14,4.5
lego star wars: the force awakens,0,0,4,2,8,14,4.285714285714286
zumba fitness world party - nintendo wii,0,0,4,2,8,14,4.285714285714286
rayman origins - nintendo wii,0,0,3,1,10,14,4.5
just dance 2016 - xbox one,1,1,1,2,9,14,4.214285714285714
xbox 360 charge base,0,0,0,4,10,14,4.714285714285714
dino crisis 2,0,0,1,2,11,14,4.714285714285714
dawn of war the complete collection,0,0,2,3,9,14,4.5
"dynasty warriors 8: xtreme legends, complete edition - ps4",0,1,1,3,9,14,4.428571428571429
dead or alive 2,1,1,2,2,8,14,4.071428571428571
street fighter alpha 3,0,0,0,2,12,14,4.857142857142857
the legend of zelda: link's awakening,0,0,0,2,12,14,4.857142857142857
mario strikers charged,0,1,2,5,6,14,4.142857142857143
carrying case for nintendo 2ds console - red,0,1,3,1,9,14,4.285714285714286
tenchu 2,0,0,2,3,9,14,4.5
mafia iii - pc,5,2,1,3,3,14,2.7857142857142856
"lucidsound ls30 - wireless universal gaming headset (black) - ps4, xbox one, pc, mobile devices",0,0,0,4,10,14,4.714285714285714
razer onza professional gaming controller - xbox 360,2,4,4,2,2,14,2.857142857142857
the incredible hulk - playstation 2,0,2,2,4,6,14,4.0
grim fandango (jewel case) - pc,0,0,1,4,9,14,4.571428571428571
angry birds star wars - nintendo wii,0,0,0,1,13,14,4.928571428571429
nintendo selects: mario super sluggers,0,0,3,3,8,14,4.357142857142857
guilty gear xrd - sign - playstation 4 standard edition,0,0,0,5,9,14,4.642857142857143
wii sports (nintendo selects),0,0,0,1,13,14,4.928571428571429
angry birds star wars - nintendo 3ds,0,0,2,3,9,14,4.5
skylanders spyro's adventure: whirlwind,0,0,0,3,11,14,4.785714285714286
angry birds star wars - xbox 360,0,0,1,3,10,14,4.642857142857143
mario vs. donkey kong 2: march of the minis,0,0,2,4,8,14,4.428571428571429
syphon filter: logan's shadow - sony psp,0,0,0,2,12,14,4.857142857142857
children of mana,0,1,5,4,4,14,3.7857142857142856
skylanders spyro's adventure: double trouble,1,0,0,3,10,14,4.5
the sims unleashed expansion pack - pc,1,2,2,1,8,14,3.9285714285714284
pro evolution soccer 2015 - playstation 4,0,0,0,4,10,14,4.714285714285714
"pdp xbox one afterglow lvl 3 stereo gaming headset 048-041, black",0,1,1,5,7,14,4.285714285714286
scribblenauts unmasked - a dc comics adventure - nintendo wii u,0,0,2,3,9,14,4.5
ds lite action replay,2,1,2,3,6,14,3.7142857142857144
payday the heist [download],0,0,2,4,8,14,4.428571428571429
danganronpa another episode: ultra despair girls - playstation vita,0,0,1,6,7,14,4.428571428571429
batman: arkham knight - limited edition - playstation 4,0,0,2,1,11,14,4.642857142857143
shadow the hedgehog - playstation 2,2,1,2,2,7,14,3.7857142857142856
ufc undisputed 2009 - xbox 360,0,0,2,7,5,14,4.214285714285714
brothers in arms: earned in blood - pc,3,2,1,1,7,14,3.5
wwe legends of wrestlemania,2,1,5,4,2,14,3.2142857142857144
chaos legion - playstation 2,0,2,3,2,7,14,4.0
cold fear - playstation 2,0,3,4,3,4,14,3.5714285714285716
mario - gold amiibo (super mario bros series),1,0,0,1,12,14,4.642857142857143
f-zero: maximum velocity,0,1,2,4,7,14,4.214285714285714
new play control! mario power tennis - nintendo wii,0,1,3,5,5,14,4.0
dynasty warriors 3,0,0,1,4,9,14,4.571428571428571
squidgrip for xbox one controllers,1,0,0,4,9,14,4.428571428571429
star wars battlefront: renegade squadron - sony psp,1,0,3,4,6,14,4.0
the sims 2 h&m fashion stuff - pc,1,0,1,5,7,14,4.214285714285714
nintendo wario amiibo (sm series) - nintendo wii u,0,0,0,1,13,14,4.928571428571429
psi-ops: the mindgate conspiracy,0,0,0,9,5,14,4.357142857142857
destroy all humans - xbox,1,0,0,4,9,14,4.428571428571429
naruto shippuden: clash of ninja revolution iii,1,0,0,5,8,14,4.357142857142857
baldur's gate: dark alliance 2 - playstation 2,0,1,1,6,6,14,4.214285714285714
midnight mysteries: the edgar allan poe conspiracy - pc,0,1,4,3,6,14,4.0
"pokemon, crystal version",0,0,2,4,8,14,4.428571428571429
skylanders trap team: sunscraper spire light element expansion pack,1,1,0,4,8,14,4.214285714285714
500gb playstation 4 console - batman arkham knight bundle[discontinued],2,1,1,1,9,14,4.0
resident evil archives: resident evil zero,1,0,0,1,12,14,4.642857142857143
turtle beach - ear force pla gaming headset - ps3 (discontinued by manufacturer),1,0,0,2,11,14,4.571428571428571
sid meiers civilization iv: the complete edition - pc,2,0,3,1,8,14,3.9285714285714284
streets of rage 2,0,0,0,0,14,14,5.0
tomb raider ii,0,0,1,0,13,14,4.857142857142857
hitman: blood money - pc,1,0,1,6,6,14,4.142857142857143
the simpsons game,1,1,4,4,4,14,3.642857142857143
el shaddai: ascension of the metatron - xbox 360,0,1,2,5,6,14,4.142857142857143
red faction 2 - pc,1,4,4,4,1,14,3.0
dynasty warriors 4 - playstation 2,0,1,4,3,6,14,4.0
halo 5: guardians - limited collector's edition - xbox one [digital game download code only/no disc included],3,1,1,0,9,14,3.7857142857142856
medal of honor: vanguard - playstation 2,2,2,4,1,5,14,3.357142857142857
lowpricenice xbox standard av cable 1st gen - not for xbox 360,0,1,0,1,12,14,4.714285714285714
the legend of zelda: majora's mask 3d limited-edition bundle - nintendo 3ds,2,0,0,0,12,14,4.428571428571429
dreamgear trimount,0,0,0,2,12,14,4.857142857142857
xbox 360 arcade console with bonus game,2,0,3,3,6,14,3.7857142857142856
batman: arkham origins - pc,0,3,4,2,5,14,3.642857142857143
legend of mana,1,2,1,5,5,14,3.7857142857142856
sid meier's civilization v game of the year - pc,3,2,1,2,6,14,3.4285714285714284
mortal kombat ii,0,0,0,2,12,14,4.857142857142857
eat lead: the return of matt hazard,2,2,3,4,3,14,3.2857142857142856
rise of kasai - playstation 2,1,2,2,4,5,14,3.7142857142857144
call of juarez - xbox 360,2,1,3,4,4,14,3.5
toukiden: the age of demons - playstation vita,0,1,1,3,9,14,4.428571428571429
infamous: second son collector's edition - playstation 4,0,0,0,2,12,14,4.857142857142857
guitar hero iii: legends of rock - playstation 3 (game only),0,0,3,1,10,14,4.5
turtle beach ear force xp510 bs-2290-01 5.1 wireless surround sound gaming headset,0,0,1,2,11,14,4.714285714285714
rocksmith 2014 edition - xbox one,2,0,1,4,7,14,4.0
lego jurassic world - xbox one standard edition,0,1,2,2,9,14,4.357142857142857
just dance kids 2 - xbox 360,0,0,3,6,5,14,4.142857142857143
the sims 4 outdoor retreat  [online game code],0,3,2,3,6,14,3.857142857142857
resistance 2 collector's edition - playstation 3,2,1,1,2,8,14,3.9285714285714284
titanfall collector's edition - xbox one,1,0,0,1,12,14,4.642857142857143
gamecube action replay,0,0,1,2,11,14,4.714285714285714
final fantasy crystal chronicles: echoes of time - nintendo ds,0,2,2,2,8,14,4.142857142857143
wanted: weapons of fate - playstation 3,0,1,2,6,5,14,4.071428571428571
wanted: weapons of fate - xbox 360,3,2,3,4,2,14,3.0
pokemon stadium 2,1,0,0,0,13,14,4.714285714285714
silent hill: shattered memories - sony psp,0,2,1,1,10,14,4.357142857142857
lego the hobbit - xbox one,1,1,1,3,8,14,4.142857142857143
arc rise fantasia - nintendo wii,0,0,2,5,7,14,4.357142857142857
disgaea 5: alliance of vengeance - playstation 4,1,3,1,1,8,14,3.857142857142857
xbox 360 live 12 month messenger gold pack,0,0,0,3,11,14,4.785714285714286
playstation 3 160gb uncharted: drake's fortune bundle,1,0,1,3,9,14,4.357142857142857
meteos - nintendo ds,0,0,5,1,8,14,4.214285714285714
illusion of gaia,0,0,1,3,10,14,4.642857142857143
skylanders spyro's adventure: sonic boom,0,0,0,2,12,14,4.857142857142857
xbox one dust cover by foamy lizard ® the original made in u.s.a. texoshield (tm) premium soft lining xb1 nylon dust guard cover [uspto patent pending] with back cable port (horizontal),0,1,2,0,11,14,4.5
datel action replay cheat system (3ds/dsi xl/dsi/ds lite) - ds blue,1,1,1,2,9,14,4.214285714285714
battlefield bad company 2 - greatest hits - playstation 3,0,1,1,1,11,14,4.571428571428571
warcraft iii: the frozen throne,0,1,0,3,10,14,4.571428571428571
"metro: last light, limited edition - xbox 360",0,0,2,6,6,14,4.285714285714286
marvel ultimate alliance 2 - playstation 2,1,3,2,3,5,14,3.5714285714285716
kinectimals - now with bears - xbox 360,0,1,2,1,10,14,4.428571428571429
pdp nfl official face-off controller for xbox one / windows,1,0,1,7,5,14,4.071428571428571
marth amiibo - europe/australia import (super smash bros series),1,0,1,0,12,14,4.571428571428571
turning point: fall of liberty,1,4,7,1,1,14,2.7857142857142856
goldeneye rogue agent - playstation 2,2,1,3,1,7,14,3.7142857142857144
hot shots golf 3 - playstation 2,0,0,1,4,9,14,4.571428571428571
pac-man and the ghostly adventures - nintendo wii u,1,0,1,2,10,14,4.428571428571429
my japanese coach - nintendo ds,0,0,2,5,7,14,4.357142857142857
"gen soft rubber jelly silicone skin cover case for sony psp 3000, black",1,2,2,3,6,14,3.7857142857142856
section 8 - pc,2,2,3,4,3,14,3.2857142857142856
the beatles: rock band,0,0,3,6,5,14,4.142857142857143
turtle beachear force xl1 officially licensed amplified stereo gaming headset for xbox 360 (discontinued by manufacturer),0,1,0,5,8,14,4.428571428571429
the club - playstation 3,0,1,4,3,6,14,4.0
shovel knight - nintendo 3ds,0,0,1,2,11,14,4.714285714285714
turning point: fall of liberty - pc,2,3,1,5,3,14,3.2857142857142856
just dance 3 - playstation 3,0,1,1,4,8,14,4.357142857142857
clive barker's jericho - pc (collector's),1,1,3,5,4,14,3.7142857142857144
pdp titanfall 2 official wired controller for xbox one & windows,1,1,1,7,4,14,3.857142857142857
sony playstation 3 250gb console - black,3,1,0,0,10,14,3.9285714285714284
"rds industries, inc officially licensed game system case for sony ps4 , ps4 slim and ps4 pro systems and accessories (discontinued by manufacturer)",1,0,0,2,11,14,4.571428571428571
the sims superstar expansion pack - pc,1,0,2,3,8,14,4.214285714285714
f.e.a.r. director's edition - pc,0,0,0,6,8,14,4.571428571428571
metroid prime pinball,0,0,2,5,7,14,4.357142857142857
pac-man collection,1,0,2,4,7,14,4.142857142857143
disney fairies: tinker bell - nintendo ds,0,0,1,3,10,14,4.642857142857143
command & conquer 3: tiberium wars - pc,1,0,5,2,6,14,3.857142857142857
touchmaster - nintendo ds,1,0,2,3,8,14,4.214285714285714
injustice 2 - ps4 [digital code],1,0,2,4,7,14,4.142857142857143
killer instinct: definitive edition - xbox one,4,2,0,1,7,14,3.357142857142857
serious sam: second encounter - pc,0,1,2,5,6,14,4.142857142857143
spider-man 3 - playstation 2,1,1,8,3,1,14,3.142857142857143
sega cd system model 1 - video game console,3,0,1,2,8,14,3.857142857142857
metal gear solid v: ground zeroes - xbox 360 standard edition,0,1,4,0,9,14,4.214285714285714
arcanum: of steamworks & magick obscura - pc,1,1,2,3,7,14,4.0
super mario strikers,0,0,1,5,8,14,4.5
quest trio - nintendo ds,0,0,2,4,8,14,4.428571428571429
"nintendo remote plus, luigi - nintendo wii",0,0,0,0,14,14,5.0
mlb 15: the show - playstation 3,0,2,2,2,8,14,4.142857142857143
fallout trilogy - 3 pack compilation,0,2,0,2,10,14,4.428571428571429
super star wars,0,1,1,3,9,14,4.428571428571429
bloody roar  3 - playstation 2,0,0,3,4,7,14,4.285714285714286
tony hawk's pro skater 2,0,0,1,5,8,14,4.5
dungeon siege 2 - pc,1,2,0,5,6,14,3.9285714285714284
no one lives forever: game of the year edition - pc,1,0,1,2,10,14,4.428571428571429
rayman,1,0,0,3,9,13,4.461538461538462
etrian odyssey untold: the millennium girl - nintendo 3ds,0,0,0,4,9,13,4.6923076923076925
king dedede amiibo - nintendo 3ds,0,0,0,2,11,13,4.846153846153846
trauma team - nintendo wii,0,0,1,3,9,13,4.615384615384615
grandia ii,0,0,2,5,6,13,4.3076923076923075
playstation move essentials pack,0,2,0,1,10,13,4.461538461538462
sid meier's civilization revolution - nintendo ds,0,0,4,9,0,13,3.6923076923076925
thief: deadly shadows,0,0,1,5,7,13,4.461538461538462
history channel: civil war: a nation divided - playstation 2,0,5,3,1,4,13,3.3076923076923075
silicon skin protective covers for nintendo wii remotes & nunchuks (bulk packaging),0,2,1,2,8,13,4.230769230769231
dragon age: inquisition -standard edition - pc [digital code],2,2,2,2,5,13,3.4615384615384617
pokemon mystery dungeon red rescue team,0,0,2,5,6,13,4.3076923076923075
peter jackson's king kong - playstation 2,1,1,2,6,3,13,3.6923076923076925
the suffering,0,1,0,7,5,13,4.230769230769231
samus amiibo - japan import (super smash bros series),0,2,0,0,11,13,4.538461538461538
full auto 2: battlelines - playstation 3,2,2,0,5,4,13,3.5384615384615383
xiii xbox,0,0,1,5,7,13,4.461538461538462
mortal kombat x: kollector's edition - playstation 4,0,1,0,1,11,13,4.6923076923076925
tiger woods pga tour 10 - nintendo wii,2,0,1,4,6,13,3.923076923076923
dr. robotnik's mean bean machine,0,0,0,3,10,13,4.769230769230769
".hack, part 3: outbreak",1,1,2,2,7,13,4.0
far cry 3: blood dragon [download],2,1,2,4,4,13,3.5384615384615383
lunar 2: eternal blue complete,0,0,0,4,9,13,4.6923076923076925
legaia 2: duel saga,2,0,1,7,3,13,3.6923076923076925
code name: s.t.e.a.m.,0,1,1,3,8,13,4.384615384615385
"insten wireless controller usb charging cable charger for microsoft xbox 360 / xbox 360 slim wireless game controllers, black",1,1,1,4,6,13,4.0
lego rock band - xbox 360,0,2,2,1,8,13,4.153846153846154
total war: rome 2 - pc,5,1,1,3,3,13,2.8461538461538463
hitman 2 silent assassin - xbox,2,0,3,3,5,13,3.6923076923076925
tokyo xtreme racer zero,1,0,2,3,7,13,4.153846153846154
toy story mania! - nintendo wii,1,2,4,3,3,13,3.3846153846153846
nintendo amibo sheik (super smash brothers series),1,0,0,1,11,13,4.615384615384615
pro evolution soccer 2016 - playstation 4 standard edition,2,0,0,2,9,13,4.230769230769231
ninja reflex - nintendo wii,2,3,4,4,0,13,2.769230769230769
silent hill 2: greatest hits,1,1,1,4,6,13,4.0
the legend of zelda: ocarina of time collector's edition,0,0,1,3,9,13,4.615384615384615
heavy fire: afghanistan - playstation 3,3,1,0,2,7,13,3.6923076923076925
sega superstars tennis,4,0,4,2,3,13,3.0
mass effect limited edition,0,0,0,2,11,13,4.846153846153846
mario hoops 3 on 3,0,0,1,5,7,13,4.461538461538462
bloodrayne 2 - xbox,0,0,2,7,4,13,4.153846153846154
call of duty: ghosts prestige edition - playstation 3,0,1,0,1,11,13,4.6923076923076925
the wolf among us - xbox one,0,0,0,2,11,13,4.846153846153846
one piece: pirate warriors 3 - playstation 4,0,0,2,1,10,13,4.615384615384615
stranglehold - playstation 3,1,1,2,5,4,13,3.769230769230769
final fantasy crystal chronicles: echoes of time - nintendo wii,3,0,2,1,7,13,3.6923076923076925
marvel ultimate alliance & forza 2,0,0,0,4,9,13,4.6923076923076925
blood rayne - xbox,0,3,4,4,2,13,3.3846153846153846
devil may cry ps3,0,0,3,1,9,13,4.461538461538462
locoroco - sony psp,0,0,0,1,12,13,4.923076923076923
playstation vita - the walking dead bundle,0,0,0,1,12,13,4.923076923076923
dragon age inquisition - standard edition - playstation 3,2,1,1,3,6,13,3.769230769230769
sniper: ghost warrior 2,1,0,3,2,7,13,4.076923076923077
breath of fire,1,0,0,6,6,13,4.230769230769231
afterglow pro controller for wii u - blue,0,0,2,3,8,13,4.461538461538462
dragon age inquisition - deluxe edition - xbox 360,2,0,0,1,10,13,4.3076923076923075
silent hunter iii (dvd-rom),2,0,2,3,6,13,3.8461538461538463
action replay gamecube,1,0,4,4,4,13,3.769230769230769
eforcity® premium hdtv hd av component cable compatible with sony psp 3000,2,0,1,1,9,13,4.153846153846154
men of valor - xbox,0,0,1,5,7,13,4.461538461538462
super nintendo super castlevania iv,0,0,1,4,8,13,4.538461538461538
front mission evolved - playstation 3,1,3,0,3,6,13,3.769230769230769
harvest moon: save the homeland,0,3,3,1,6,13,3.769230769230769
final fantasy xiv collector's edition - pc,7,2,0,1,3,13,2.3076923076923075
mafia - playstation 2,0,1,1,4,7,13,4.3076923076923075
infamous first light - ps4 [digital code],0,0,1,6,6,13,4.384615384615385
neverwinter nights diamond,0,1,3,1,8,13,4.230769230769231
nancy drew: warnings at waverly academy - pc,0,0,4,6,3,13,3.923076923076923
pixel junk monsters deluxe - sony psp,0,0,0,3,10,13,4.769230769230769
wild arms 3 - playstation 2,3,1,1,3,5,13,3.4615384615384617
sony playstation move shooting attachment,0,0,2,2,9,13,4.538461538461538
playstation 3 frontman wireless guitar - white,4,0,1,4,4,13,3.3076923076923075
rise of the argonauts - xbox 360,0,1,5,4,3,13,3.6923076923076925
shovel knight - playstation 4,0,0,3,3,7,13,4.3076923076923075
xbox 360 250gb halo reach console bundle,2,0,0,1,10,13,4.3076923076923075
teenage mutant ninja turtles (ps2),1,1,2,2,7,13,4.0
skylanders swap force starter pack - playstation 3,0,0,0,2,11,13,4.846153846153846
doom 3 resurrection of evil - xbox,0,1,2,3,7,13,4.230769230769231
ninja gaiden sigma 2 plus - playstation vita,0,0,0,5,8,13,4.615384615384615
3ds xl / dsi xl leather case holds up 3x game cartridge,0,0,0,4,9,13,4.6923076923076925
xbox 360 4gb console with kinect holiday value,0,0,1,1,11,13,4.769230769230769
"ggg0031 8 pack translucent dust protection sleeves ""easy read"" for nintendo nes video game system cartridges/games, retro cart cases and covers",0,0,0,0,13,13,5.0
turtle beach call of duty: ghosts ear force spectre limited edition gaming headset -microsoft xbox 360,0,2,0,5,6,13,4.153846153846154
thrustmaster t3pa add-on,0,1,0,2,10,13,4.615384615384615
myst 10th anniversary dvd edition - pc/mac,1,1,1,3,7,13,4.076923076923077
yaiba: ninja gaiden z,1,2,2,2,6,13,3.769230769230769
blast corps,2,0,1,5,5,13,3.8461538461538463
f1 2015 (formula one) - playstation 4,1,0,1,2,9,13,4.384615384615385
syphon filter: dark mirror - sony psp (jewel case),0,0,0,4,9,13,4.6923076923076925
grand theft auto - playstation,1,0,1,4,7,13,4.230769230769231
x-men 2: clone wars,1,0,0,4,8,13,4.384615384615385
tiger woods pga tour 11 - playstation 3,1,0,3,2,7,13,4.076923076923077
mass effect 2 collector's edition -xbox 360,0,0,1,1,11,13,4.769230769230769
scribblenauts unmasked - a dc comics adventure - nintendo 3ds,0,0,1,4,8,13,4.538461538461538
xbox 360 pro 20 gb,4,0,0,3,6,13,3.5384615384615383
heroes of might & magic v,2,2,3,4,2,13,3.1538461538461537
capcom vs snk: millennium fight 2000,0,1,1,3,8,13,4.384615384615385
tom clancy's ghost recon - playstation 2,0,0,2,7,4,13,4.153846153846154
aliens vs. predator - pc,3,0,4,4,2,13,3.1538461538461537
disney infinity 3.0 edition star wars starter pack for xbox one,0,1,2,5,5,13,4.076923076923077
halo 2 multiplayer map pack - xbox,2,0,1,4,6,13,3.923076923076923
test drive unlimited 2 - xbox 360,2,4,2,2,3,13,3.0
wwe wrestlemania xix,2,0,1,2,8,13,4.076923076923077
microsoft (x-box) xbox live,0,0,2,2,9,13,4.538461538461538
the elder scrolls iv: oblivion,1,0,1,4,7,13,4.230769230769231
lord of the rings: the return of the king,0,0,1,6,6,13,4.384615384615385
rygar: the legendary adventure,0,0,3,4,6,13,4.230769230769231
nancy drew: the phantom of venice - pc,0,0,2,4,7,13,4.384615384615385
harvest moon: tree of tranquility - nintendo wii,0,1,2,2,8,13,4.3076923076923075
the lord of the rings: the two towers,0,0,3,3,7,13,4.3076923076923075
nba 2k16 : early tip-off edition - playstation 4,1,1,0,1,10,13,4.384615384615385
phineas and ferb: across the 2nd dimension - playstation 3,1,1,2,3,6,13,3.923076923076923
quake 64,0,1,2,2,8,13,4.3076923076923075
xbox 360 pro 60gb console,3,1,1,2,6,13,3.5384615384615383
spider-man: web of shadows - nintendo wii,0,2,2,3,6,13,4.0
gameshark 2,2,1,1,2,7,13,3.8461538461538463
lost dimension - playstation 3,0,0,5,4,4,13,3.923076923076923
nostalgia - nintendo ds,0,1,4,2,6,13,4.0
pro evolution soccer 2015 - playstation 3,0,0,0,2,11,13,4.846153846153846
tom clancy's splinter cell - gamecube,0,2,1,3,7,13,4.153846153846154
mass effect 2 collector's edition - pc,0,0,1,4,8,13,4.538461538461538
titan quest - pc,0,3,0,2,8,13,4.153846153846154
attack on titan - playstation 4,1,0,1,5,6,13,4.153846153846154
baldur's gate 2: ultimate collection (shadows of amn and throne of bhaal) - pc,1,0,0,3,9,13,4.461538461538462
civil war: secrets of the north & south (hidden mysteries) - pc,2,3,5,0,3,13,2.923076923076923
legend of kay anniversary - wii u,0,0,2,4,7,13,4.384615384615385
"warhammer 40,000: dawn of war -- dark crusade",0,0,0,1,12,13,4.923076923076923
prey - xbox one,0,0,2,3,8,13,4.461538461538462
hot shots golf open tee - sony psp,0,0,1,7,5,13,4.3076923076923075
star wars battlefront ii (greatest hits) - sony psp,1,0,1,4,7,13,4.230769230769231
battlefield hardline deluxe edition - playstation 4,1,1,0,6,5,13,4.0
psp portable memory 32mb,1,0,3,1,8,13,4.153846153846154
teenage mutant ninja turtles,0,1,3,1,8,13,4.230769230769231
tales of xillia (collector's edition) - playstation 3,0,0,0,2,11,13,4.846153846153846
jaws unleashed - playstation 2,0,0,3,5,5,13,4.153846153846154
thief ii: the metal age,0,0,1,5,7,13,4.461538461538462
the sims 4 get to work,0,0,0,2,11,13,4.846153846153846
the sims 2: mansion & garden stuff - pc,0,0,0,1,12,13,4.923076923076923
nintendo dsi xl red bundle with mario kart,0,0,0,4,9,13,4.6923076923076925
razer sabertooth elite gaming controller for xbox 360,3,3,0,0,7,13,3.3846153846153846
pdp xbox one lvl 1 chat gaming headset,1,2,3,3,4,13,3.5384615384615383
far cry 3 [online game code],3,1,0,3,6,13,3.6153846153846154
enter the matrix - gamecube,0,0,2,4,7,13,4.384615384615385
delta force: black hawk down - pc,2,0,2,6,3,13,3.6153846153846154
def jam vendetta,0,0,1,8,4,13,4.230769230769231
generic orange spice controller pad for gamecube and wii,0,0,2,3,8,13,4.461538461538462
jet set radio future / sega gt 2002,0,0,0,4,9,13,4.6923076923076925
nascar 09 - xbox 360,0,0,2,4,7,13,4.384615384615385
big beach sports - nintendo wii,0,0,4,2,7,13,4.230769230769231
ufc undisputed 2009 - playstation 3,1,0,1,6,5,13,4.076923076923077
mechwarrior 4: vengeance,0,0,1,7,5,13,4.3076923076923075
pokemon art academy - 3ds,1,0,0,3,9,13,4.461538461538462
guild wars trilogy - pc,1,1,1,4,6,13,4.0
retro bit nintendo nes entertainment system (silver/black),1,1,3,4,4,13,3.6923076923076925
command and conquer generals: zero hour expansion pack - pc,0,0,1,1,11,13,4.769230769230769
the wolf among us,1,0,2,3,7,13,4.153846153846154
game boy advance micro silver,2,0,3,1,7,13,3.8461538461538463
the sims 3 seasons [online game code],2,0,1,1,9,13,4.153846153846154
disney infinity 3.0 edition: disney pixar's inside out play set - not machine specific,0,1,0,5,7,13,4.384615384615385
disgaea 2: cursed memories,0,0,0,6,7,13,4.538461538461538
doom,0,0,0,1,12,13,4.923076923076923
the last guardian - collector's edition - playstation 4,0,0,0,2,11,13,4.846153846153846
ps2 dualshock 2 controller - emerald,0,0,1,4,8,13,4.538461538461538
skylanders giants: single character pack core series 2 fright rider,0,0,1,1,11,13,4.769230769230769
star trek voyager:  elite force - pc,0,0,2,5,6,13,4.3076923076923075
tenchu: stealth assassins,0,0,1,4,8,13,4.538461538461538
wall-e - playstation 2,0,0,0,5,8,13,4.615384615384615
assassin's creed: the americas collection - playstation 3 standard edition,0,0,1,1,11,13,4.769230769230769
disney infinity starter pack wii,2,2,1,1,7,13,3.6923076923076925
medal of honor 10th anniversary bundle - pc,1,1,1,2,8,13,4.153846153846154
tank! tank! tank! - nintendo wii u,0,2,4,4,3,13,3.6153846153846154
icewind dale - pc,0,2,4,3,4,13,3.6923076923076925
command & conquer 3: tiberium wars - xbox 360,2,1,3,2,5,13,3.5384615384615383
lumines - sony psp,1,2,0,4,6,13,3.923076923076923
mega man x8 - playstation 2,0,1,4,5,3,13,3.769230769230769
soldier of fortune: payback,1,1,4,3,4,13,3.6153846153846154
icewind dale 2 - pc,0,1,1,3,8,13,4.384615384615385
king's field: the ancient city,1,0,0,5,7,13,4.3076923076923075
turok: evolution,1,3,1,3,5,13,3.6153846153846154
call of duty: black ops ii [hardened edition] - playstation 3,0,1,0,1,11,13,4.6923076923076925
need for speed underground 2,0,1,1,4,7,13,4.3076923076923075
guitar hero iii: legends of rock - ps2,0,0,2,4,7,13,4.384615384615385
ea sports fifa soccer - playstation vita,0,0,0,4,9,13,4.6923076923076925
lords of the fallen - xbox one,1,0,2,4,6,13,4.076923076923077
star wars jedi knight: dark forces 2  (jewel case) - pc,1,1,1,4,6,13,4.0
league of legends starter pack - na server only [instant access],1,0,2,3,7,13,4.153846153846154
konami collector's series: arcade advanced,0,0,1,4,8,13,4.538461538461538
light blue yarn yoshi amiibo (yoshi's woolly world series),0,0,0,1,12,13,4.923076923076923
resident evil origins collection - xbox one standard edition,0,1,0,1,11,13,4.6923076923076925
the sims 3: master suite stuff,0,2,1,1,9,13,4.3076923076923075
xenoblade chronicles x special edition - wii u,0,0,3,0,10,13,4.538461538461538
dark souls ii collector's edition playstation 3,0,0,2,1,10,13,4.615384615384615
powera fusion pro controller for xbox one,1,4,1,5,2,13,3.230769230769231
xbox one 500gb white console - special edition quantum break bundle,3,0,1,1,8,13,3.8461538461538463
lego star wars: force awakens deluxe edition - xbox one,0,1,0,2,10,13,4.615384615384615
mega man 5,0,1,2,5,5,13,4.076923076923077
mario classic color amiibo - japan import (super smash bros series),0,0,0,1,12,13,4.923076923076923
tomb raider anniversary for wii,1,0,3,7,2,13,3.6923076923076925
metal gear,2,0,3,1,7,13,3.8461538461538463
tony hawk's pro skater 2x,0,2,1,5,5,13,4.0
amazing adventures the riddle of two knights,0,0,1,4,8,13,4.538461538461538
guitar hero ii: game & guitar controller bundle,1,0,1,3,8,13,4.3076923076923075
skylanders superchargers: drivers stormblade character pack,0,0,0,0,13,13,5.0
timmy & tommy nook amiibo - nintendo wii u,0,0,1,0,12,13,4.846153846153846
devil may cry (5th anniversary collection),0,0,2,3,8,13,4.461538461538462
nyko power pack for playstation 4,2,3,1,1,6,13,3.4615384615384617
playstation 4 dualshock 4 bundle [discontinued],2,0,1,1,9,13,4.153846153846154
tekken 5 - playstation 2,0,0,0,3,10,13,4.769230769230769
terraria - xbox 360,0,0,1,2,10,13,4.6923076923076925
simcity societies - pc,2,3,3,3,2,13,3.0
sega dreamcast controller (original gray),0,0,2,4,7,13,4.384615384615385
back to the future: the game - 30th anniversary edition - playstation 4,1,0,2,2,8,13,4.230769230769231
"playstation 3, 20gb",0,0,2,4,7,13,4.384615384615385
tekken advance,0,1,1,8,3,13,4.0
tony hawk's pro skater,0,0,3,1,9,13,4.461538461538462
south park: the stick of truth grand wizard edition - playstation 3 collectors edition,0,1,1,1,10,13,4.538461538461538
gamecube memory card 59,1,1,1,4,6,13,4.0
minecraft: story mode - season disc - playstation 4,2,0,1,1,9,13,4.153846153846154
xbox 360 call of duty: modern warfare 3 wireless headset with bluetooth,0,3,1,0,9,13,4.153846153846154
the sims 2: castaway - nintendo wii,0,0,2,4,7,13,4.384615384615385
battlefield  2 the complete collection dvd - pc,1,0,3,2,7,13,4.076923076923077
rumble roses - playstation 2,1,0,4,3,5,13,3.8461538461538463
"skylanders spyro's adventure triple character pack (eruptor, chop chop, bash)",0,0,0,2,11,13,4.846153846153846
green yarn yoshi amiibo (yoshi's woolly world series),0,0,0,2,11,13,4.846153846153846
sony playstation controller - gray (non-dualshock),0,0,2,4,7,13,4.384615384615385
medal of honor: airborne - playstation 3,3,1,1,2,6,13,3.5384615384615383
syphon filter: dark mirror - playstation 2,0,1,3,1,8,13,4.230769230769231
deer drive legends 3ds,4,6,3,0,0,13,1.9230769230769231
sniper elite iii - xbox 360 standard edition,0,0,1,4,8,13,4.538461538461538
10ft ps4 controller charging cable for playstation 4 dual shock 4,1,0,0,0,12,13,4.6923076923076925
shantae: half-genie hero - risky beats edition - playstation vita,0,0,0,1,12,13,4.923076923076923
professor layton and the azran legacy,0,1,2,1,9,13,4.384615384615385
unreal tournament iii - xbox 360,0,1,3,4,5,13,4.0
"phantasy star online, episode i & ii",0,1,0,1,11,13,4.6923076923076925
microsoft xbox high definition av pack,0,1,1,1,10,13,4.538461538461538
playstation 3 the last of us & batman: arkham origins bundle,0,0,0,3,10,13,4.769230769230769
ps3 new owner's kit,0,1,0,2,10,13,4.615384615384615
taito legends 2 - playstation 2,0,0,1,2,10,13,4.6923076923076925
def jam icon - playstation 3,3,2,1,2,5,13,3.3076923076923075
minecraft: story mode - season disc - xbox 360,0,0,0,4,9,13,4.6923076923076925
call of duty: black ops iii  steelbook edition  playstation 4 - amazon exclusive,0,2,0,3,8,13,4.3076923076923075
tetris,1,0,3,0,9,13,4.230769230769231
cta digital wii grand slam sports pack (white) sports pack 6 in 1 for wii,0,1,1,1,10,13,4.538461538461538
feel the magic xy & xx - nintendo ds,1,0,4,4,4,13,3.769230769230769
gtron retro usb super classic controller for pc/mac,0,0,2,4,7,13,4.384615384615385
nintendo wii component cable av cable for hdtv/edtv high definition 480p  (bulk packaging),0,1,0,0,12,13,4.769230769230769
shin megami tensei: persona 2 innocent sin - sony psp,0,0,2,2,9,13,4.538461538461538
tomee hd vga cable for dreamcast,2,1,0,2,8,13,4.0
disney magical world - nintendo 3ds,0,0,0,4,9,13,4.6923076923076925
disney infinity 3.0 edition: star wars the force awakens power disc pack,0,0,0,1,12,13,4.923076923076923
disney infinity 3.0 edition: star wars the force awakens poe dameron figure,0,0,0,2,11,13,4.846153846153846
hori pokken tournament pro pad limited edition controller for nintendo wii u,0,0,0,3,10,13,4.769230769230769
godzilla unleashed - nintendo wii,0,1,7,3,2,13,3.4615384615384617
might & magic: heroes vi [download],1,3,3,1,5,13,3.4615384615384617
the chronicles of riddick: escape from butcher bay (developer's cut),1,1,3,3,5,13,3.769230769230769
champions return to arms - playstation 2,0,2,3,2,6,13,3.923076923076923
dark souls ii: scholar of the first sin - xbox one,1,0,2,1,9,13,4.3076923076923075
aion: the tower of eternity collector edition - pc,2,5,2,4,0,13,2.6153846153846154
dead island definitive collection - xbox one,1,0,1,2,9,13,4.384615384615385
playstation 2 singstar bundle - ceramic white,0,0,0,2,11,13,4.846153846153846
pdp donkey kong barrel game card storage - nintendo 2ds,0,0,0,1,12,13,4.923076923076923
madden nfl 2003 - playstation 2,1,0,2,3,7,13,4.153846153846154
battlefield 4 premium service  [online game code],2,1,2,2,6,13,3.6923076923076925
lego batman - pc,0,0,4,2,6,12,4.166666666666667
mxgp 14: the official motocross videogame,1,0,3,2,6,12,4.0
"insten battery door compatible with sony psp 1000 series, black",0,0,0,4,8,12,4.666666666666667
rock band 3 wireless keyboard for xbox 360,0,0,3,3,6,12,4.25
hori fighting commander 4 controller for playstation 4/3,1,0,2,0,9,12,4.333333333333333
blinx the time sweeper - xbox,1,0,3,3,5,12,3.9166666666666665
microsoft xbox 360 e 250gb console,0,0,0,1,11,12,4.916666666666667
teenage mutant ninja turtles,1,1,6,2,2,12,3.25
tiger woods pga tour 09 - playstation 3,0,0,0,6,6,12,4.5
fallout 4 season pass - ps4 [digital code],3,0,2,1,6,12,3.5833333333333335
deal or no deal - nintendo wii,0,0,4,2,6,12,4.166666666666667
pinball hall of fame the gottlieb collection - playstation 2,0,0,4,3,5,12,4.083333333333333
rock band 3 wireless keyboard for playstation 3,0,1,0,1,10,12,4.666666666666667
cta digital multi-function carrying case for xbox one xb1-mfc,0,0,0,3,9,12,4.75
call of duty: black ops iii - standard edition - xbox 360,2,1,0,1,8,12,4.0
need for speed - deluxe edition - playstation 4,1,1,1,1,8,12,4.166666666666667
sandisk gaming sd™ wii - 2gb sdsdg-2048-a11,2,0,3,1,6,12,3.75
turtle beach - ear force xbox 360 talkback cable with foam windscreen- xbox 360,0,0,0,0,12,12,5.0
turtle beach - ear force recon 50p stereo gaming headset - ps4 and xbox one (compatible w/ xbox one controller w/ 3.5mm headset jack),2,1,3,2,4,12,3.4166666666666665
style savvy - nintendo ds,0,0,1,3,8,12,4.583333333333333
f1 2011 - playstation 3,0,0,1,3,8,12,4.583333333333333
tactics ogre: the knight of lodis,0,1,0,2,9,12,4.583333333333333
pink yarn yoshi amiibo (yoshi's woolly world series),0,0,0,1,11,12,4.916666666666667
hyperdimension neptunia victory - playstation 3,1,1,0,4,6,12,4.083333333333333
corpse party: blood drive - everafter edition - playstation vita,0,0,4,2,6,12,4.166666666666667
onechanbara: bikini samurai squad - xbox 360,0,1,4,4,3,12,3.75
wii rock band special edition,0,0,2,6,4,12,4.166666666666667
game boy advance game link cable,0,0,1,3,8,12,4.583333333333333
madden nfl 2004 - xbox,1,1,1,4,5,12,3.9166666666666665
counter-strike: source - pc,1,1,1,3,6,12,4.0
ducktales - remastered ps3 - playstation 3,1,1,1,3,6,12,4.0
"batman: arkham city - collector's edition, xbox 360",0,0,0,0,12,12,5.0
skylanders spyro's adventure: bash,0,0,0,4,8,12,4.666666666666667
"xbox 360 green full parts set (thumbsticks, d-pad, buttons, triggers, bumpers, bottom trim) for your controller (abxy,guide,start, back)",0,0,3,2,7,12,4.333333333333333
nba live 2003,0,1,1,2,8,12,4.416666666666667
pro evolution soccer 2012 - xbox 360,0,0,2,2,8,12,4.5
world of warcraft: cataclysm collector's edition,0,0,1,4,7,12,4.5
namco museum,0,0,2,1,9,12,4.583333333333333
the sims 3 collector's edition - pc,3,0,3,3,3,12,3.25
sudeki - xbox,0,0,2,9,1,12,3.9166666666666665
test drive unlimited - xbox 360,0,0,2,5,5,12,4.25
mortal kombat x fight pad for playstation 4 and playstation 3,3,3,1,2,3,12,2.9166666666666665
fallout 1 / fallout 2 bundle (jewel case) - pc,0,0,0,3,9,12,4.75
baldur's gate - pc,0,1,3,5,3,12,3.8333333333333335
facebreaker - xbox 360,4,0,0,3,5,12,3.4166666666666665
rampage total destruction - playstation 2,0,1,2,2,7,12,4.25
king of fighters 2006 - playstation 2,0,1,1,3,7,12,4.333333333333333
unlimited saga - playstation 2,7,2,2,0,1,12,1.8333333333333333
tropico - pc,1,0,2,6,3,12,3.8333333333333335
guild wars factions - pc,2,1,3,1,5,12,3.5
sony playstation 3 dualshock 3 wireless controller - white,0,0,0,0,12,12,5.0
rollercoaster tycoon 3 platinum - pc,1,1,1,2,7,12,4.083333333333333
bodycount - playstation 3,1,1,1,4,5,12,3.9166666666666665
nba 2k10 - xbox 360,0,1,1,4,6,12,4.25
r-type command - sony psp,3,0,0,4,5,12,3.6666666666666665
tekken 3d prime edition - nintendo 3ds,0,1,1,5,5,12,4.166666666666667
blood wake,1,0,8,2,1,12,3.1666666666666665
"turtle beach - ear force px51 wireless gaming headset - dolby digital - ps3, xbox 360",0,1,2,3,6,12,4.166666666666667
rollercoaster tycoon gold edition: rollercoaster tycoon / loopy landscapes / corkscrew follies,0,0,1,3,8,12,4.583333333333333
breath of fire ii,1,0,1,2,8,12,4.333333333333333
lego jurassic world - nintendo 3ds,0,0,1,2,9,12,4.666666666666667
dragonball z budokai tenkaichi - playstation 2,0,0,2,4,6,12,4.333333333333333
dancedance revolution ps3,1,2,1,2,6,12,3.8333333333333335
otomedius excellent - xbox 360,1,1,5,2,3,12,3.4166666666666665
guitar hero - aerosmith - playstation 2 (game only),0,0,6,4,2,12,3.6666666666666665
skylanders swap force starter pack - xbox one,0,0,0,1,11,12,4.916666666666667
lego star wars ii: the original trilogy - sony psp,0,0,1,4,7,12,4.5
vampire rain - xbox 360,3,1,4,2,2,12,2.9166666666666665
rabbids invasion,1,1,1,5,4,12,3.8333333333333335
winter sports the ultimate challenge,4,0,0,4,4,12,3.3333333333333335
tony hawk's pro skater 2,0,1,0,2,9,12,4.583333333333333
earth defense force 4.1: the shadow of new despair - playstation 4,0,1,1,1,9,12,4.5
tiger woods pga tour 07 - xbox 360,0,0,1,7,4,12,4.25
wii nunchuk cord free wireless adaptor,0,2,2,2,6,12,4.0
zenses: rainforest edition - nintendo ds,0,0,1,0,11,12,4.833333333333333
mega man x collection - gamecube,0,1,1,3,7,12,4.333333333333333
final fantasy xi online - pc,2,0,1,5,4,12,3.75
dark souls iii - xbox one standard edition,0,1,1,4,6,12,4.25
tekken tag tournament 2 xbox 360,1,0,0,4,7,12,4.333333333333333
metal gear solid legacy collection - playstation 3,0,0,0,1,11,12,4.916666666666667
the sly collection - playstation vita,1,1,0,0,10,12,4.416666666666667
need for speed rivals (complete edition) - playstation 4,0,1,4,1,6,12,4.0
homeworld 2,1,0,2,4,5,12,4.0
microsoft flight simulator 2004: a century of flight - pc,1,0,1,4,6,12,4.166666666666667
amazonbasics playstation 3 wired usb chat headset (officially licensed by sony),0,0,1,6,5,12,4.333333333333333
virtua fighter 5 online - xbox 360,0,1,4,3,4,12,3.8333333333333335
dreamgear comfort grip for playstation vita (pch-1000),1,1,2,1,7,12,4.0
mysims - nintendo ds,0,1,2,4,5,12,4.083333333333333
tekken - dark resurrection - sony psp,0,0,0,0,12,12,5.0
mortal kombat armageddon - xbox,0,1,0,7,4,12,4.166666666666667
super nintendo ac adapter power supply,0,0,2,2,8,12,4.5
batman begins - playstation 2,0,1,2,2,7,12,4.25
activision skylanders giants scarlet ninjini,0,0,0,0,12,12,5.0
final fantasy viii,0,0,2,2,8,12,4.5
batman: arkham origins collector's edition - playstation 3,1,1,0,1,9,12,4.333333333333333
sin episodes: emergence dvd - pc,0,4,4,1,3,12,3.25
tomb raider game of the year,0,0,0,2,10,12,4.833333333333333
wolfenstein 3d,0,0,4,2,6,12,4.166666666666667
sid meiers civilization iv beyond the sword - pc,0,0,2,4,6,12,4.333333333333333
disney infinity 3.0 edition: toy box takeover (a toy box expansion game) - not machine specific,1,0,1,1,9,12,4.416666666666667
okage: shadow king,2,1,3,4,2,12,3.25
the sims 2 (special dvd edition),3,0,0,3,6,12,3.75
pokemon pinball: ruby and sapphire,1,0,0,1,10,12,4.583333333333333
the walking dead season 2,0,0,2,1,9,12,4.583333333333333
black mirror - pc,0,1,4,5,2,12,3.6666666666666665
rock candy wii gesture controller - purple,1,0,1,2,8,12,4.333333333333333
mega man legacy collection,0,1,3,2,6,12,4.083333333333333
nintendo animal crossing amiibo cards series 3 nintendo wii u,0,0,0,2,10,12,4.833333333333333
disney infinity 3.0 edition: star wars obi-wan kenobi figure,0,1,0,0,11,12,4.75
rampage: total destruction - nintendo wii,0,2,2,4,4,12,3.8333333333333335
mlb 13 the show - playstation vita,0,1,0,3,8,12,4.5
madden nfl 06 - xbox,1,1,2,3,5,12,3.8333333333333335
grand theft auto: episodes from liberty city - pc,2,0,1,2,7,12,4.0
final fight,1,1,1,3,6,12,4.0
panzer dragoon - sega saturn,0,1,0,1,10,12,4.666666666666667
unreal (jewel case) - pc,0,0,2,4,6,12,4.333333333333333
club penguin: elite penguin force - nintendo ds,0,1,0,2,9,12,4.583333333333333
maximo vs army of zin - playstation 2,0,0,0,8,4,12,4.333333333333333
turtle beach titanfall ear force atlas official xbox one xbox 360 pc gaming headset,0,0,5,3,4,12,3.9166666666666665
the godfather: the game,1,0,0,4,7,12,4.333333333333333
sonic spinball gen,0,1,2,2,7,12,4.25
the lord of the rings: battle for middle earth 2 - pc,0,1,1,5,5,12,4.166666666666667
"uspro® playstation 2 wired controller, gamepad, black",0,0,0,5,7,12,4.583333333333333
rez,0,0,0,2,10,12,4.833333333333333
mysims kingdom - nintendo wii,0,0,1,3,8,12,4.583333333333333
injustice 2 - playstation 4 standard edition with comic,0,0,2,3,7,12,4.416666666666667
call of duty: advanced warfare atlas pro edition - xbox one,0,0,1,1,10,12,4.75
freedom force - pc,0,1,0,4,7,12,4.416666666666667
resident evil 3: nemesis,0,0,0,3,9,12,4.75
call of juarez: gunslinger [download],0,1,0,6,5,12,4.25
l.a. noire: the complete edition - pc,1,0,5,3,3,12,3.5833333333333335
lego star wars iii: the clone wars - nintendo wii,1,0,1,3,7,12,4.25
wwe 2k16 - xbox 360,1,0,1,3,7,12,4.25
batman: arkham origins [download],0,0,5,3,4,12,3.9166666666666665
nba 2k6 - xbox 360,0,0,2,4,6,12,4.333333333333333
the spongebob squarepants movie,0,2,1,3,6,12,4.083333333333333
pinball hall of fame the williams collection,1,0,1,4,6,12,4.166666666666667
major league baseball 2k7 - xbox 360,0,2,2,4,4,12,3.8333333333333335
lord of the rings the return of the king - gamecube,1,0,1,6,4,12,4.0
playstation 4 500gb console - star wars battlefront limited edition bundle [discontinued],0,0,0,2,10,12,4.833333333333333
tomee zapp gun for nes,3,1,1,1,6,12,3.5
the sims 3 ambitions  [instant access],2,0,2,1,7,12,3.9166666666666665
clive barker's jericho - playstation 3,0,1,2,1,8,12,4.333333333333333
amazing adventures: the forgotten dynasty,0,0,2,1,9,12,4.583333333333333
saints row iv: re-elected + gat out of hell,0,2,2,2,6,12,4.0
pac-man and the ghostly adventures - playstation 3,1,0,2,4,5,12,4.0
the sims castaway stories - pc,0,0,6,2,4,12,3.8333333333333335
ace combat zero: the belkan war,0,0,3,3,6,12,4.25
disney infinity:star wars starter pack - 3.0 edition - ps4,0,1,0,2,9,12,4.583333333333333
hyperdimension neptunia re;birth2: sisters generation - playstation vita,0,0,1,2,9,12,4.666666666666667
"insten 3 pcs screen protector lcd guard compatible with nintendo wii u gamepad controller , ultra clear, smooth, bubble free, fingerprint resistant",1,0,0,2,9,12,4.5
fatal frame,0,0,1,4,7,12,4.5
the godfather: blackhand edition for wii,0,0,0,6,6,12,4.5
"xim 4 keyboard and mouse adapter for ps4, xbox one, 360, ps3",0,1,1,0,10,12,4.583333333333333
star wars: empire at war - pc,0,3,2,4,3,12,3.5833333333333335
flingsmash with wii remote plus - black,0,1,4,3,4,12,3.8333333333333335
fracture,0,1,4,2,5,12,3.9166666666666665
disney infinity 3.0 edition: star wars the force awakens kylo ren figure,0,0,0,0,12,12,5.0
tomb raider survival/collector's edition -xbox 360,0,1,0,5,6,12,4.333333333333333
the sims 3: town life stuff - pc/mac,0,1,2,1,8,12,4.333333333333333
need for speed: rivals,4,0,3,2,3,12,3.0
kontrolfreek ultra performance thumbsticks for xbox one controller,1,0,0,0,11,12,4.666666666666667
nancy drew: the haunting of castle malloy - pc,0,0,5,3,4,12,3.9166666666666665
nintendogs + cats:  golden retriever and new friends,0,0,1,2,9,12,4.666666666666667
stubbs the zombie in rebel without a pulse - xbox,0,0,1,4,7,12,4.5
need for speed: prostreet - xbox 360,1,3,2,0,6,12,3.5833333333333335
power stand for wii u,0,1,2,3,6,12,4.166666666666667
capcom classics collection reloaded - sony psp,0,0,1,3,8,12,4.583333333333333
nintendo selects: super mario galaxy 2,0,0,1,4,7,12,4.5
mishap: an accidental haunting [download],1,1,1,5,4,12,3.8333333333333335
child of light - playstation vita standard edition,0,0,1,3,8,12,4.583333333333333
double dragon iii: the sacred stones,1,3,3,3,2,12,3.1666666666666665
24 the game - playstation 2,0,2,3,5,2,12,3.5833333333333335
the simpsons game,0,2,4,2,4,12,3.6666666666666665
xbox 360 ear force xp500 programmable wireless headset,0,2,1,2,7,12,4.166666666666667
gears of war: ultimate edition day one version - xbox one digital code,0,1,1,3,7,12,4.333333333333333
skylanders swap force starter pack - nintendo wii,0,0,1,5,6,12,4.416666666666667
playstation 4 500gb uncharted: the nathan drake collection bundle (digital download code)[discontinued],1,0,0,0,11,12,4.666666666666667
world in conflict - pc,0,2,1,3,6,12,4.083333333333333
rayman 3: hoodlum havoc,0,0,1,2,9,12,4.666666666666667
mega man x3,0,0,3,2,7,12,4.333333333333333
tales of phantasia,0,2,1,5,4,12,3.9166666666666665
"2 pack - gator crunch wii gamecube 6ft extension cable / cord (lifetime warranty, bulk packaging)",0,0,1,0,11,12,4.833333333333333
zone of the enders: the 2nd runner,0,0,2,1,9,12,4.583333333333333
xbox 360 e 250gb kinect holiday value bundle,1,0,2,1,8,12,4.25
tony hawk's underground - xbox,0,0,2,5,5,12,4.25
gameshark video game enhancer [playstation],0,0,1,0,11,12,4.833333333333333
grand theft auto: san andreas ( dvd-rom ) - pc,0,0,0,3,9,12,4.75
etrian odyssey ii: heroes of lagaard,0,0,0,4,8,12,4.666666666666667
medal of honor frontline - gamecube,1,2,2,5,2,12,3.4166666666666665
dead rising 2: off the record - xbox 360,0,0,1,3,8,12,4.583333333333333
brothers in arms: road to hill 30 - playstation 2,0,1,1,4,6,12,4.25
world of warcraft - pc/mac,0,1,0,4,7,12,4.416666666666667
wwe smackdown vs. raw 2008 - xbox 360,0,2,1,4,5,12,4.0
xbox 360 core console [old version],1,1,4,4,2,12,3.4166666666666665
splinter cell double agent - xbox,0,0,0,6,6,12,4.5
turtle beach ear force z22 amplified pc gaming headset,0,0,1,6,5,12,4.333333333333333
death to spies - pc,1,3,6,1,1,12,2.8333333333333335
wario: master of disguise - nintendo ds,0,1,4,2,5,12,3.9166666666666665
guitar hero live - playstation 4,0,1,1,4,6,12,4.25
just dance disney party 2 - xbox one standard edition,0,0,3,5,4,12,4.083333333333333
el shaddai: ascension of the metatron - playstation 3,0,0,4,3,5,12,4.083333333333333
age of empires iii complete collection [download],1,0,2,3,6,12,4.083333333333333
the simpsons game,0,2,3,3,4,12,3.75
x-men,0,1,3,1,7,12,4.166666666666667
phantasy star online,0,3,0,2,7,12,4.083333333333333
mega man legends,0,0,1,5,6,12,4.416666666666667
pro controller u for wii and wii u - black,3,0,0,5,4,12,3.5833333333333335
spider-man 2: enter electro,0,0,0,5,7,12,4.583333333333333
jurassic: the hunted - playstation 3,1,0,2,3,6,12,4.083333333333333
mega man 7 - nintendo super nes,0,0,1,2,9,12,4.666666666666667
overlord: raising hell - playstation 3,0,0,3,3,6,12,4.25
dragon warrior iii - gameboy color,0,0,0,1,11,12,4.916666666666667
e-mods gaming® 4x replacement black analogue thumbsticks for xbox one/ ps4 controllers,1,0,0,1,10,12,4.583333333333333
spider-man: web of shadows - playstation 2,0,2,0,4,6,12,4.166666666666667
ar nosurge: ode to an unborn star - playstation 3,0,2,1,2,7,12,4.166666666666667
nitroplus blasterz: heroines infinite duel - playstation 4,0,0,3,3,6,12,4.25
tom clancy's rainbow six lockdown - xbox,3,1,2,1,5,12,3.3333333333333335
wwf super wrestlemania,3,3,3,1,2,12,2.6666666666666665
old skool gamecube / wii compatible controller - purple,0,1,1,0,10,12,4.583333333333333
senran kagura 2: deep crimson - 'double d' - nintendo 3ds,1,0,0,1,10,12,4.583333333333333
nintendo mii swordfighter amiibo (super smash bros. series) for wii u,0,0,0,0,12,12,5.0
brave story: new traveler - sony psp,0,0,1,7,4,12,4.25
wipeout pulse - sony psp,1,0,0,3,8,12,4.416666666666667
magical starsign - nintendo ds,0,1,2,3,6,12,4.166666666666667
the sims deluxe edition - pc,1,0,0,5,6,12,4.25
finding nemo - playstation 2,0,1,1,4,6,12,4.25
playstation gold wireless stereo headset -  20th anniversary edition,0,1,0,2,9,12,4.583333333333333
spider-man: the edge of time - xbox 360,0,1,4,3,4,12,3.8333333333333335
the sopranos: road to respect,3,4,1,2,2,12,2.6666666666666665
mega man x6,2,2,2,4,2,12,3.1666666666666665
nfl fever 2002,0,0,2,3,7,12,4.416666666666667
dishonored 2 - pc,0,2,3,4,3,12,3.6666666666666665
call of duty: ghosts prestige edition - playstation 4,0,0,2,2,8,12,4.5
xbox 360 console halo 3 special edition (with hdmi),2,0,0,0,10,12,4.333333333333333
infamous first light - ps4 (physical version),1,0,0,2,9,12,4.5
powera voroar dualshock 4 dual charger with free usb cable,1,0,0,1,10,12,4.583333333333333
"nintendo wii remote plus, yoshi",0,0,0,1,11,12,4.916666666666667
half life 2 - pc,0,3,2,0,7,12,3.9166666666666665
teenage mutant ninja turtles - nintendo wii,0,1,0,2,9,12,4.583333333333333
bravely default collector's edition - nintendo 3ds,0,0,1,1,10,12,4.75
bound by flame - xbox 360,1,1,3,2,5,12,3.75
bards tale - playstation 2,0,0,1,5,6,12,4.416666666666667
half-life expansion pack: opposing force - pc,0,0,1,4,7,12,4.5
the elder scrolls v: skyrim legendary edition [online game code],1,0,3,0,8,12,4.166666666666667
disgaea d2: a brighter darkness - playstation 3,0,0,1,3,8,12,4.583333333333333
sonic cd,1,0,1,2,8,12,4.333333333333333
men of valor - pc,1,3,5,1,2,12,3.0
"turtle beach elite pro tournament gaming headset - comfortec fit system and truspeak technology -xbox one, ps4, pc and mobile gaming - xbox one",1,0,0,5,6,12,4.25
aliens infestation,0,0,1,5,6,12,4.416666666666667
naruto shippuden: ultimate storm 3 full burst - playstation 3,0,0,2,0,10,12,4.666666666666667
risen 2: dark waters - complete package - xbox 360 (special edition),0,2,2,4,4,12,3.8333333333333335
playstation 2 multitap,2,0,2,3,5,12,3.75
battlefield: bad company gold edition -xbox 360,0,0,0,5,7,12,4.583333333333333
harvest moon back to nature,0,0,0,0,12,12,5.0
nintendogs chihuahua & friends,0,1,2,0,9,12,4.416666666666667
burnout,0,2,3,1,6,12,3.9166666666666665
nhl 13 - xbox 360,2,0,1,1,8,12,4.083333333333333
final fantasy xi: ultimate collection abyssea edition [download],4,0,1,1,6,12,3.4166666666666665
rampage 2: universal tour,0,0,3,3,6,12,4.25
xbox one 500gb console - gears of war: ultimate edition bundle,2,0,0,1,9,12,4.25
fantastic pets - xbox 360,0,1,3,1,7,12,4.166666666666667
7th dragon iii code: vfd - nintendo 3ds,1,1,1,3,6,12,4.0
nintendo official mini elite transporter case for 3ds - black,0,0,1,6,5,12,4.333333333333333
kingdom hearts 3d dream drop distance - collector's edition - nintendo 3ds,0,0,0,0,12,12,5.0
hour of victory - xbox 360,5,1,2,0,4,12,2.75
lego batman 3: beyond gotham - playstation vita,0,0,0,1,11,12,4.916666666666667
lego batman 3: beyond gotham - nintendo 3ds,0,0,0,1,11,12,4.916666666666667
"mario & sonic at the london 2012 olympic games, nintendo 3ds",1,0,2,2,7,12,4.166666666666667
lichdom: battlemage - playstation 4,7,1,1,2,1,12,2.0833333333333335
skylanders superchargers: vehicle burn cycle character pack,0,0,0,1,11,12,4.916666666666667
tribes 2 - pc,0,1,3,4,4,12,3.9166666666666665
twisted lands: shadow town [mac download],0,0,5,5,2,12,3.75
wild arms 2,0,0,2,4,6,12,4.333333333333333
guild wars 2 heroic edition [download],2,1,4,1,4,12,3.3333333333333335
secret agent clank - playstation 2,0,0,4,1,7,12,4.25
puss in boots: move compatible - playstation 3,0,0,1,3,8,12,4.583333333333333
the dark eye: drakensang - pc,1,0,1,4,6,12,4.166666666666667
dynasty warriors 8 empires - playstation 4,0,1,1,4,6,12,4.25
shin megami tensei: devil survivor - nintendo ds,0,0,2,3,7,12,4.416666666666667
pokemon ranger,0,1,2,5,4,12,4.0
nintendo ds lite clear crystal hard case nds case,0,0,0,0,12,12,5.0
thief [online game code],1,0,5,3,3,12,3.5833333333333335
ssx tricky nintendo gamecube,0,0,0,5,7,12,4.583333333333333
champions online - pc,1,2,4,5,0,12,3.0833333333333335
wwf raw (platinum hits),4,3,4,1,0,12,2.1666666666666665
quake iii: arena,1,1,4,4,2,12,3.4166666666666665
arma gold edition - pc,5,1,0,0,6,12,3.0833333333333335
nvidia shield portable,0,0,2,2,8,12,4.5
"black xbox 360 controller shell housing (thumbsticks, d-pad, buttons, ect)",0,0,0,2,10,12,4.833333333333333
skylanders spyro's adventure starter pack - nintendo 3ds,0,0,2,1,9,12,4.583333333333333
world of warcraft: legion - standard edition - pc/mac,1,0,1,3,7,12,4.25
scooby doo! first frights - playstation 2,0,0,0,2,10,12,4.833333333333333
"everydaysource compatible with microsoft xbox 360 headset w/ mic , black",1,1,1,1,8,12,4.166666666666667
nintendo rosalina amiibo (sm series) - nintendo wii u,0,0,0,2,10,12,4.833333333333333
animal crossing: city folk (nintendo selects),0,1,4,2,5,12,3.9166666666666665
"xcom: enemy unknown special edition - pc (includes: game, dlc, artbook, poster & soundtrack)",0,2,1,3,6,12,4.083333333333333
klonoa - nintendo wii,0,0,0,3,9,12,4.75
mortal kombat 4,1,0,2,2,7,12,4.166666666666667
flatout: ultimate carnage - pc,0,2,0,4,6,12,4.166666666666667
tom clancy's ghost recon 2: summit strike,0,0,3,5,4,12,4.083333333333333
controller gear controller stand v1.0 - officially licensed - black - xbox one,0,1,1,1,9,12,4.5
darkwatch - xbox,0,0,2,4,6,12,4.333333333333333
metroid prime: federation force,2,1,1,4,4,12,3.5833333333333335
simcity 3000 unlimited,0,1,1,4,6,12,4.25
ar tonelico qoga: knell of ar ciel,0,1,1,4,6,12,4.25
valkyrie profile 2: silmeria - playstation 2,0,0,2,2,8,12,4.5
spider-man 3 - nintendo wii,1,2,2,1,6,12,3.75
mortal kombat deception - xbox,0,0,2,2,8,12,4.5
shin megami tensei: persona - sony psp,0,2,3,3,4,12,3.75
jewel master cradle of persia,0,0,0,3,9,12,4.75
hitman: blood money - playstation 2,0,0,2,3,7,12,4.416666666666667
quake 2 - pc,1,1,0,3,7,12,4.166666666666667
transformers - playstation 2,0,0,3,3,6,12,4.25
forza horizon 2 for xbox 360,2,0,3,2,5,12,3.6666666666666665
bioshock infinite: the complete edition - playstation 3,0,0,1,3,8,12,4.583333333333333
call of duty: modern warfare 3 hardened edition,1,0,1,2,8,12,4.333333333333333
udraw gametablet with udraw studio - nintendo wii,0,2,0,2,8,12,4.333333333333333
microsoft flight simulator x deluxe dvd - pc,1,0,4,3,4,12,3.75
"insten premium component audio video cable compatible with nintendo wii and nintendo wii u , replacement 5 rca video stereo audio av cable to hdtv edtv , 4.67 feet [nintendo wii]",0,0,2,2,8,12,4.5
grandia,0,2,3,2,5,12,3.8333333333333335
naruto shippuden: ultimate ninja storm revolution - xbox 360,1,0,0,1,10,12,4.583333333333333
xbox 360 250gb spring value bundle,0,0,0,0,12,12,5.0
ghosts 'n goblins,1,1,1,3,6,12,4.0
the sims 3 - nintendo 3ds,3,1,1,1,6,12,3.5
link cable for game boy advance and gamecube,0,0,0,2,10,12,4.833333333333333
battlefield hardline deluxe edition - xbox one,1,1,3,3,4,12,3.6666666666666665
"midnight club 3, dub edition, sony psp",0,0,2,3,7,12,4.416666666666667
nintendo 3ds xl retro mario hard pouch,0,0,0,4,8,12,4.666666666666667
the legend of heroes: trails of cold steel ii - playstation 3,0,0,0,1,11,12,4.916666666666667
namco museum,0,2,1,3,6,12,4.083333333333333
xbox one special edition dusk shadow wireless controller [without bluetooth],0,0,1,2,9,12,4.666666666666667
donkey kong,0,0,0,1,11,12,4.916666666666667
the scruffs [download],0,0,2,5,5,12,4.25
the stronghold collection [download],2,0,2,2,6,12,3.8333333333333335
command & conquer 3: kane's wrath - pc,0,2,0,0,10,12,4.5
lego rock band - playstation 3,0,1,0,1,10,12,4.666666666666667
tom clancy's the division (gold edition) - xbox one,1,0,0,2,9,12,4.5
ghost rider - playstation 2,1,0,1,5,5,12,4.083333333333333
breath of fire 4,0,0,0,4,8,12,4.666666666666667
valhalla knights 3 - playstation vita,1,3,3,1,4,12,3.3333333333333335
toukiden: kiwami - playstation 4,0,1,0,2,9,12,4.583333333333333
the wolf among us - playstation 3,0,1,0,2,9,12,4.583333333333333
need for speed: shift - pc,1,2,5,2,2,12,3.1666666666666665
ultimate mortal kombat 3,1,1,3,2,5,12,3.75
abzu - playstation 4,0,2,0,1,9,12,4.416666666666667
gothic 3 - pc game,4,3,0,4,1,12,2.5833333333333335
just dance kids 2014 - nintendo wii u,0,0,2,6,4,12,4.166666666666667
microsoft xbox 360 wired controller,1,0,1,1,9,12,4.416666666666667
new york times crosswords - nintendo ds,0,0,2,4,6,12,4.333333333333333
mega man zx - nintendo ds,0,1,0,4,7,12,4.416666666666667
harvest moon 64,0,0,1,3,8,12,4.583333333333333
gun - xbox,0,0,2,8,2,12,4.0
suffering ties that bind - playstation 2,0,0,2,0,10,12,4.666666666666667
mario vs. donkey kong mini-land mayhem!,0,0,3,1,8,12,4.416666666666667
train simulator - pc,2,0,2,4,4,12,3.6666666666666665
mortal kombat 3,3,1,1,3,4,12,3.3333333333333335
metro last light - pc,0,0,0,3,9,12,4.75
beautiful katamari - xbox 360,0,1,4,4,3,12,3.75
shadow of rome - playstation 2,1,0,1,0,10,12,4.5
lara croft and the guardian of light [download],0,0,3,5,4,12,4.083333333333333
nba live 15 - xbox one,1,2,1,4,4,12,3.6666666666666665
top spin 4 - playstation 3,1,0,0,3,8,12,4.416666666666667
nyko power pak+ for 3ds,1,1,0,2,8,12,4.25
wild earth: african safari - nintendo wii,0,0,6,2,4,12,3.8333333333333335
unreal championship 2 the liandri conflict - xbox,1,1,2,2,6,12,3.9166666666666665
"turtle beach elite pro tactical audio controller - dts headphone:x 7.1 surround sound and superhuman hearing - tournament gaming - ps4, xbox one and pc - playstation 4",1,0,0,4,7,12,4.333333333333333
kontrolfreek fps freek vortex performance thumbsticks for playstation 4 controller (ps4),0,0,3,2,7,12,4.333333333333333
mario party 6 with microphone,0,0,3,3,6,12,4.25
castlevania: dracula x,0,1,4,3,4,12,3.8333333333333335
the punisher,0,0,1,4,7,12,4.5
call of duty: infinite warfare - standard edition - pc,1,0,2,3,6,12,4.083333333333333
sony playstation network card - $10 [online game code],0,0,0,0,12,12,5.0
ace combat assault horizon legacy - nintendo 3ds,0,0,1,4,7,12,4.5
golden axe - sega genesis,0,1,2,3,5,11,4.090909090909091
cirka controller for n64 (blue),1,1,1,1,7,11,4.090909090909091
nba 2k9,0,0,2,1,8,11,4.545454545454546
urbz: sims in the city - playstation 2,1,0,2,5,3,11,3.8181818181818183
guitar hero live - xbox one,0,2,1,2,6,11,4.090909090909091
singstar microphones - playstation 2,0,0,1,2,8,11,4.636363636363637
xbox 360 cooling station,0,1,1,4,5,11,4.181818181818182
street fighter alpha 3 max - sony psp,0,0,1,2,8,11,4.636363636363637
nintendo skylanders swap force bundle - nintendo wii u,1,0,0,4,6,11,4.2727272727272725
the elder scrolls iv: oblivion - game of the year edition - pc,1,3,1,2,4,11,3.4545454545454546
dr. mario 64,0,1,1,1,8,11,4.454545454545454
call of duty: advanced warfare (gold edition) - xbox one,0,2,1,1,7,11,4.181818181818182
dungeons & dragons: heroes,0,0,3,4,4,11,4.090909090909091
jak and daxter collection - playstation vita,3,2,0,0,6,11,3.3636363636363638
fighting force,0,1,1,3,6,11,4.2727272727272725
fifa street - playstation 3,1,0,1,2,7,11,4.2727272727272725
brunswick pro bowling - nintendo wii,2,2,3,4,0,11,2.8181818181818183
dirt 2 - playstation 3,0,0,1,4,6,11,4.454545454545454
gen ac adapter power supply cord for xbox 360 slim,1,1,1,1,7,11,4.090909090909091
battlefield bad company 2 - platinum hits -xbox 360,0,0,0,3,8,11,4.7272727272727275
need for speed: most wanted - gamecube,0,0,1,4,6,11,4.454545454545454
criminal girls: invite only - playstation vita,0,1,0,4,6,11,4.363636363636363
baldur's gate: dark alliance 2,0,0,3,3,5,11,4.181818181818182
burnout revenge,0,0,0,3,8,11,4.7272727272727275
shulk amiibo (super smash bros series),0,0,0,0,11,11,5.0
playstation gold wireless stereo headset - jet black [old model],2,2,1,2,4,11,3.3636363636363638
castlevania chronicles,0,0,3,3,5,11,4.181818181818182
dungeon travelers 2: the royal library & the monster seal - playstation vita,0,0,0,4,7,11,4.636363636363637
disney infinity 3.0 edition: star wars han solo figure,0,0,0,0,11,11,5.0
nintendo pokemon go plus,2,0,0,4,5,11,3.909090909090909
drakan: the ancients' gates,0,0,0,7,4,11,4.363636363636363
batman forever,3,5,1,0,2,11,2.3636363636363638
fracture - xbox 360,0,2,5,1,3,11,3.4545454545454546
"batman: arkham asylum - collector's edition, xbox 360",1,1,1,1,7,11,4.090909090909091
the sims: complete collection - pc,1,0,1,0,9,11,4.454545454545454
playstation 3 system backpack - black (discontinued by manufacturer),0,0,0,2,9,11,4.818181818181818
rock band 2 - playstation 3 (game only),0,0,0,1,10,11,4.909090909090909
rock band 2 - nintendo wii (game only),0,0,0,3,8,11,4.7272727272727275
mercury meltdown: revolution - nintendo wii,0,1,0,4,6,11,4.363636363636363
playstation 3 rock band 2 special edition,0,1,3,2,5,11,4.0
komodo playstation 1 memory card 1mb,0,0,1,3,7,11,4.545454545454546
medal of honor heroes - sony psp,0,0,1,2,8,11,4.636363636363637
system shock 2 - pc,0,1,1,3,6,11,4.2727272727272725
monster hunter - playstation 2,0,1,1,7,2,11,3.909090909090909
xbox 360 wireless microphone,1,0,2,2,6,11,4.090909090909091
phantasy star collection,0,0,1,1,9,11,4.7272727272727275
the house of the dead 2,1,0,1,5,4,11,4.0
acc ps4 dualshock 4 charging station by sony #main,1,0,1,2,7,11,4.2727272727272725
monopoly tycoon - pc,1,3,3,3,1,11,3.0
front mission 4 - playstation 2,0,0,3,3,5,11,4.181818181818182
star wars dark forces,0,1,2,1,7,11,4.2727272727272725
nyko wand for wii,0,5,0,4,2,11,3.272727272727273
cars 2: the video game - xbox 360,1,0,2,2,6,11,4.090909090909091
bangai o spirits,0,1,0,5,5,11,4.2727272727272725
lego dimensions starter pack - xbox one,0,1,1,2,7,11,4.363636363636363
divine divinity - pc,0,0,0,2,9,11,4.818181818181818
blood omen: legacy of kain,0,0,0,2,9,11,4.818181818181818
killer instinct,1,0,1,2,7,11,4.2727272727272725
dragon ball z: the legacy of goku ii,0,0,0,4,7,11,4.636363636363637
burnout 2: point of impact,0,0,0,1,10,11,4.909090909090909
postal 2 - pc,3,2,2,1,3,11,2.909090909090909
velvet assassin - pc,0,4,2,2,3,11,3.3636363636363638
rogue warrior - playstation 3,0,2,2,1,6,11,4.0
lego legends of chima: laval's journey - nintendo 3ds,0,1,0,2,8,11,4.545454545454546
"skylanders spyro's adventure triple character pack (drobot, flameslinger, stump smash)",0,0,1,1,9,11,4.7272727272727275
rechargeable replacement battery pack for nintendo ds lite,0,1,0,2,8,11,4.545454545454546
ninja gaiden 3: razor's edge - xbox 360,1,0,3,1,6,11,4.0
call of duty: modern warfare 3 hardened edition,0,0,0,2,9,11,4.818181818181818
need for speed rivals (complete edition) - xbox one,1,1,0,3,6,11,4.090909090909091
midtown madness 3,0,0,2,5,4,11,4.181818181818182
prince of persia: the two thrones,0,0,1,5,5,11,4.363636363636363
xbox 360 tomb raider limited edition wireless controller,0,1,0,0,10,11,4.7272727272727275
gun - xbox 360,0,0,2,4,5,11,4.2727272727272725
skate 2: platinum hits edition,0,0,2,5,4,11,4.181818181818182
nhl 14 - playstation 3,2,0,0,1,8,11,4.181818181818182
xbox component video cable,0,0,3,1,7,11,4.363636363636363
ncaa football 08 - xbox 360,1,2,0,5,3,11,3.6363636363636362
ea sports mma - playstation 3,1,0,1,2,7,11,4.2727272727272725
"warhammer 40,000 dawn of war game of the year - pc",1,0,2,0,8,11,4.2727272727272725
just dance kids 2 - nintendo wii,0,0,0,1,10,11,4.909090909090909
agatha christie: and then there were none - pc,1,1,5,2,2,11,3.272727272727273
xiii - playstation 2,2,1,0,4,4,11,3.6363636363636362
nintendo ds game card case 16 - black,0,0,0,0,11,11,5.0
valkyrie profile: covenant of the plume - nintendo ds,1,2,1,2,5,11,3.727272727272727
nba street volume 2,0,0,0,1,10,11,4.909090909090909
zombies ate my neighbors,0,0,0,2,9,11,4.818181818181818
skylanders trap team: mini power punch pet vac character pack,0,0,0,0,11,11,5.0
golden axe ii - sega genesis,1,0,2,3,5,11,4.0
pokemon pinball,0,0,0,1,10,11,4.909090909090909
all pro football 2k8 - playstation 3,1,0,5,2,3,11,3.5454545454545454
the legend of zelda: ocarina of time (w/ master quest),0,0,0,2,9,11,4.818181818181818
lunar: dragon song - nintendo ds,0,2,5,0,4,11,3.5454545454545454
batarang wireless controller for ps3,2,2,1,3,3,11,3.272727272727273
guitar hero 5 stand alone software - playstation 3 (game only),0,1,4,2,4,11,3.8181818181818183
sega classics collection - playstation 2,1,1,1,3,5,11,3.909090909090909
game genie - sega genesis,0,1,0,2,8,11,4.545454545454546
tomb raider greatest hits - playstation 3,1,0,0,2,8,11,4.454545454545454
barrow hill: curse of the ancient circle - pc,0,2,1,6,2,11,3.727272727272727
super star wars: return of the jedi - nintendo super nes,1,0,0,2,8,11,4.454545454545454
altered beast - sega genesis,0,0,1,5,5,11,4.363636363636363
age of mythology:  titans - pc,1,0,1,1,8,11,4.363636363636363
xbox 360 play & charge kit with black controller,0,0,1,1,9,11,4.7272727272727275
just dance 2017 - playstation 4,0,0,0,4,7,11,4.636363636363637
need for speed rivals (complete edition) - playstation 3,0,1,1,2,7,11,4.363636363636363
prinny: can i really be the hero? - sony psp,0,0,6,2,3,11,3.727272727272727
pinball hall of fame: the williams collection - xbox 360,0,0,0,1,10,11,4.909090909090909
just dance 2017 - xbox one,1,0,0,6,4,11,4.090909090909091
kirby amiibo - japan import (super smash bros series),1,0,0,0,10,11,4.636363636363637
sniper elite,0,0,0,2,9,11,4.818181818181818
smackdown vs. raw 2006,0,1,1,2,7,11,4.363636363636363
guitar hero iii: legends of rock - nintendo wii (game only),0,0,2,4,5,11,4.2727272727272725
split / second - pc,1,0,1,1,8,11,4.363636363636363
sonic mega collection plus - xbox,0,0,2,4,5,11,4.2727272727272725
wario land: super mario land 3,0,0,3,0,8,11,4.454545454545454
freedom fighters: battle for liberty island,1,0,2,4,4,11,3.909090909090909
magna carta: tears of blood - deluxe box set - playstation 2,3,5,0,1,2,11,2.4545454545454546
phantasy star portable - sony psp,0,1,2,2,6,11,4.181818181818182
x2 wolverine's revenge - playstation 2,0,1,2,1,7,11,4.2727272727272725
"generic snes / n64 / gamecube av cable (tv adapter for super nintendo, nintendo 64 and gc) (bulk packaging) - nintendo 64",0,0,0,2,9,11,4.818181818181818
john romero's daikatana,2,3,1,3,2,11,3.0
dark souls iii: day 1 edition - xbox one,0,0,0,4,7,11,4.636363636363637
ms. pac-man,0,0,1,2,8,11,4.636363636363637
crash bandicoot 2: n-tranced,0,0,1,1,9,11,4.7272727272727275
vampire: the masquerade redemption - pc,0,2,3,3,3,11,3.6363636363636362
transformers: revenge of the fallen - xbox 360,0,2,4,2,3,11,3.5454545454545454
cooking mama 4: kitchen magic - nintendo 3ds,0,0,0,2,9,11,4.818181818181818
freedom fighters - pc,1,0,2,4,4,11,3.909090909090909
romancing saga - playstation 2,0,2,2,3,4,11,3.8181818181818183
startropics,0,0,0,2,9,11,4.818181818181818
dance dance revolution hottest party 3 bundle - nintendo wii,0,0,1,3,7,11,4.545454545454546
nancy drew: ransom of the seven ships - pc,0,4,4,1,2,11,3.090909090909091
cool spot,0,1,1,2,7,11,4.363636363636363
rock band 4 pro-cymbals expansion drum kit,0,2,2,1,6,11,4.0
conception ii: children of the seven stars - nintendo 3ds,0,0,1,5,5,11,4.363636363636363
farming simulator 15 - playstation 4,1,1,1,4,4,11,3.8181818181818183
transformers: revenge of the fallen - playstation 3,1,0,2,2,6,11,4.090909090909091
kung fu,0,0,1,2,8,11,4.636363636363637
guitar hero 2 bundle with guitar -xbox 360,0,0,1,7,3,11,4.181818181818182
fallout 4 - playstation 4,1,0,2,1,7,11,4.181818181818182
sonic riders: zero gravity - playstation 2,0,0,4,0,7,11,4.2727272727272725
metal gear solid v: the phantom pain - playstation 4 collector's edition,0,0,1,2,8,11,4.636363636363637
jak & daxter: the lost frontier - sony psp,0,0,3,3,5,11,4.181818181818182
lego battles - nintendo ds,0,0,0,3,8,11,4.7272727272727275
left 4 dead - game of the year edition - pc,2,1,1,2,5,11,3.6363636363636362
sid meier's civilization iii complete,1,2,1,2,5,11,3.727272727272727
dirt 3,1,0,2,3,5,11,4.0
breath of fire iii,0,0,2,2,7,11,4.454545454545454
burnout dominator - playstation 2,0,1,1,2,7,11,4.363636363636363
pdp afterglow kral ps4 wireless headset,0,1,1,1,8,11,4.454545454545454
the witcher: wild hunt (comic bundle) - xbox one,1,0,0,1,9,11,4.545454545454546
dishonored 2 premium collector's edition - playstation 4,1,0,0,1,9,11,4.545454545454546
final fantasy legend,1,0,1,1,8,11,4.363636363636363
skylanders spyro's adventure: flameslinger,0,0,0,3,8,11,4.7272727272727275
battlefield 2: special forces expansion pack - pc,1,1,1,5,3,11,3.727272727272727
operation flashpoint: cold war crisis - pc,1,2,0,5,3,11,3.6363636363636362
metroid (classic nes series),0,3,1,0,7,11,4.0
playstation 3 dualshock 3 wireless controller (crimson red),0,0,1,1,9,11,4.7272727272727275
playstation portable limited edition ratchet & clank entertainment pack - mystic silver,0,0,0,3,8,11,4.7272727272727275
blazing angels 2: secret missions of wwii - playstation 3,0,0,2,1,8,11,4.545454545454546
amazing adventures: around the world - pc,0,0,3,1,7,11,4.363636363636363
enter the matrix - pc,0,2,2,5,2,11,3.6363636363636362
7 wonders 2 - nintendo ds,0,1,2,1,7,11,4.2727272727272725
gray matter [download],3,0,2,3,3,11,3.272727272727273
operation flashpoint: red river - playstation 3,1,0,0,4,6,11,4.2727272727272725
the amazing spider-man 2 - xbox one,0,1,2,3,5,11,4.090909090909091
capcom vs. snk 2 eo,1,0,1,3,6,11,4.181818181818182
xbox 360 500gb console - forza horizon 2 bundle,2,1,1,0,7,11,3.8181818181818183
cross edge - playstation 3,1,1,4,3,2,11,3.3636363636363638
bully scholarship edition - pc,2,2,1,2,4,11,3.3636363636363638
wario amiibo - japan import (super smash bros series),0,0,0,0,11,11,5.0
skylanders spyro's adventure: prism break,0,0,1,3,7,11,4.545454545454546
sacred 2: fallen angel,8,0,2,0,1,11,1.7272727272727273
drakensang: complete saga (drakensang / river of time / phileasson's secret),1,1,0,6,3,11,3.8181818181818183
trenro ps4 thumb grips edge series pro,0,4,3,1,3,11,3.272727272727273
wwe raw 2 - xbox,1,2,4,4,0,11,3.0
dengeki bunko: fighting climax - playstation vita standard edition,0,0,3,1,7,11,4.363636363636363
disney infinity 3.0 edition: alice figure - not machine specific,1,0,0,0,10,11,4.636363636363637
guild wars: nightfall - pc,1,1,2,4,3,11,3.6363636363636362
rock band 4 wireless guitar bundle - playstation 4,2,4,1,0,4,11,3.0
retro amiibo 3-pack,1,0,0,0,10,11,4.636363636363637
disney tangled - nintendo ds,0,0,3,5,3,11,4.0
dirt rally - xbox one,2,1,1,1,6,11,3.727272727272727
f1: 2010 - playstation 3,0,0,1,5,5,11,4.363636363636363
sony playstation 2 infared dvd remote controller kit,0,0,0,5,6,11,4.545454545454546
disney infinity 3.0 edition: tomorrowland power disc pack,0,0,0,0,11,11,5.0
xbox dvd movie playback kit,1,1,2,2,5,11,3.8181818181818183
r.c. pro-am,0,0,0,1,10,11,4.909090909090909
syberia 2 - pc,0,0,3,3,5,11,4.181818181818182
call of duty: black ops ii [hardened edition] - xbox 360,0,1,2,1,7,11,4.2727272727272725
nintendo 64 ac power adapter,0,0,2,1,8,11,4.545454545454546
skylanders giants: lightcore drobot character,0,0,1,2,8,11,4.636363636363637
squidgrip for ps4 controllers (controller not included),1,1,2,1,6,11,3.909090909090909
atari classics evolved - sony psp,1,2,1,2,5,11,3.727272727272727
dungeon siege: legends of aranna expansion pack - pc,0,0,5,5,1,11,3.6363636363636362
the lost cases of sherlock holmes - pc,1,0,2,2,6,11,4.090909090909091
hidden objects: mystery stories (nintendo ds),1,2,1,1,6,11,3.8181818181818183
skylanders giants: single character pack core series 2 bash,0,0,0,0,11,11,5.0
the amazing spider-man - ps vita,0,1,1,2,7,11,4.363636363636363
lego star wars 2 original trilogy - gamecube,0,0,0,1,10,11,4.909090909090909
pool of radiance: ruins of myth drannor - pc,4,3,2,2,0,11,2.1818181818181817
little nemo: the dream master,1,0,1,4,5,11,4.090909090909091
street fighter iii 3rd strike,0,0,1,6,4,11,4.2727272727272725
nintendo mii gunner amiibo (super smash bros. series) for wii u,0,0,0,1,10,11,4.909090909090909
starcraft ii: legacy of the void - collector's edition,0,1,1,0,9,11,4.545454545454546
professor layton and the last specter - nintendo ds,0,0,0,4,7,11,4.636363636363637
tropico 5 (ps4) - playstation 4 standard edition,3,0,3,0,5,11,3.3636363636363638
nintendo 3ds xl - yoshi edition,0,0,0,1,10,11,4.909090909090909
outlaw golf xbox,0,1,1,1,8,11,4.454545454545454
doom: collector's edition,0,0,1,3,7,11,4.545454545454546
power a media expansion bar for ps3 slim,1,0,1,2,7,11,4.2727272727272725
tom clancy's rainbow six 3: raven shield - pc,1,0,4,4,2,11,3.5454545454545454
nancy drew: shadow at the water's edge - pc/mac,0,0,1,4,6,11,4.454545454545454
street fighter ex3,1,1,2,3,4,11,3.727272727272727
skylanders giants battlepack #1 - chop chop - dragonfire cannon - shroomboom,0,1,1,1,8,11,4.454545454545454
dance dance revolution max 2 - playstation 2,0,0,0,3,8,11,4.7272727272727275
word jong - nintendo ds,0,0,1,3,7,11,4.545454545454546
skylanders giants battle pack #2: zap - scorpion striker - hot dog,0,0,1,1,9,11,4.7272727272727275
ty the tasmanian tiger - playstation 2,0,0,0,2,9,11,4.818181818181818
ty the tasmanian tiger,0,1,1,3,6,11,4.2727272727272725
ducktales - remastered 360 - xbox 360,0,0,1,2,8,11,4.636363636363637
nyko charge link - mini usb charge and sync cable for playstation 3,0,0,0,2,9,11,4.818181818181818
ultimate combo pack - infamous 1&2 dual pack & blue dualshock 3 - playstation 3,0,0,1,1,9,11,4.7272727272727275
mindjack - playstation 3,2,0,2,3,4,11,3.6363636363636362
insten deluxe usb cooling fan [quad-fan] compatible with sony playstation 3 ps3 console,1,0,1,2,7,11,4.2727272727272725
dragon ball xenoverse - xbox 360,2,0,1,2,6,11,3.909090909090909
xbox 360 250gb holiday value bundle,1,0,0,1,9,11,4.545454545454546
need for speed hot pursuit - nintendo wii,1,1,3,1,5,11,3.727272727272727
dynasty warriors 5: empires,1,0,1,5,4,11,4.0
cyber · grip rubber coating (for 3ds ll),0,1,1,3,6,11,4.2727272727272725
dreamfall: the longest journey - pc,1,2,2,1,5,11,3.6363636363636362
my spanish coach - nintendo ds,0,0,3,2,6,11,4.2727272727272725
gradius v,0,0,0,3,8,11,4.7272727272727275
toy story 2,1,0,2,0,8,11,4.2727272727272725
summer sports paradise island - nintendo wii,0,2,0,0,9,11,4.454545454545454
wheel of fortune - nintendo ds,0,1,0,1,9,11,4.636363636363637
mass effect,2,2,0,2,5,11,3.5454545454545454
mortal kombat 3,1,0,2,0,8,11,4.2727272727272725
pac man world 2,0,0,0,6,5,11,4.454545454545454
midway arcade treasures - playstation 2,0,0,2,1,8,11,4.545454545454546
dungeons & dragons tactics - sony psp,0,1,2,5,3,11,3.909090909090909
touch my katamari - playstation vita,0,1,4,3,3,11,3.727272727272727
disney infinity 3.0 edition: mickey mouse figure,1,0,0,1,9,11,4.545454545454546
nintendo wii u console mario kart 8 deluxe set with 32 gb storage - black,6,0,1,3,1,11,2.3636363636363638
destroy all humans! big willy unleashed,3,0,0,5,3,11,3.4545454545454546
star wars: the old republic - 2400 cartel coins + exclusive item [online game code],0,0,1,2,8,11,4.636363636363637
deadpool - xbox one,1,0,1,5,4,11,4.0
zone of the enders hd collection,1,0,0,3,7,11,4.363636363636363
kingdom under fire: the crusaders,1,1,3,3,3,11,3.5454545454545454
disney princess: my fairytale adventure - nintendo wii,0,0,0,3,8,11,4.7272727272727275
total war: shogun 2,1,1,0,1,8,11,4.2727272727272725
enhanced thumb grips quad pack brand new for playstation vita,2,2,3,2,2,11,3.0
spyro: season of ice,1,1,1,2,6,11,4.0
dragon quest swords: the masked queen and tower of mirrors - nintendo wii,0,2,6,2,1,11,3.1818181818181817
nintendo pokemon x & y limited edition 3 ds xl (blue),2,0,0,2,7,11,4.090909090909091
sea of thieves - xbox one,4,6,0,0,1,11,1.9090909090909092
star wars: the clone wars,0,1,2,3,5,11,4.090909090909091
socom u.s. navy seals fireteam bravo 2 - sony psp,0,0,0,2,9,11,4.818181818181818
xbox 360 wireless controller - chrome silver,0,0,0,0,11,11,5.0
skylanders superchargers: vehicle splatter splasher character pack,0,0,1,0,10,11,4.818181818181818
alone in the dark 4: the new nightmare,0,1,2,2,6,11,4.181818181818182
hyperdimension neptunia (premium edition),0,3,2,2,4,11,3.6363636363636362
pariah - xbox,1,2,2,5,1,11,3.272727272727273
smarty pants: trivia for everyone - nintendo wii,0,2,2,2,5,11,3.909090909090909
"wario ware, inc. mega party games!",1,0,4,2,4,11,3.727272727272727
borderlands: the pre-sequel - pc,1,2,2,1,5,11,3.6363636363636362
devil may cry 4 collector's edition - playstation 3,0,0,0,2,9,11,4.818181818181818
theatrhythm final fantasy: curtain call - nintendo 3ds,0,0,0,2,9,11,4.818181818181818
risen 2: dark waters - complete package - playstation 3 (special edition),1,1,2,5,2,11,3.5454545454545454
adventure time: explore the dungeon because i don't know! - collector's edition,0,2,3,1,5,11,3.8181818181818183
rocket league: collector's edition - xbox one,1,1,0,0,9,11,4.363636363636363
conflict: denied ops - xbox 360,0,5,5,0,1,11,2.727272727272727
agatha christie : murder on the orient express - pc,0,3,2,4,2,11,3.4545454545454546
killzone: liberation - sony psp,0,0,1,2,8,11,4.636363636363637
virtua tennis - sega dreamcast,0,0,1,3,7,11,4.545454545454546
cronusmax plus cross cover gaming adapter for ps4 ps3 xbox one xbox 360 windows pc,2,2,0,0,7,11,3.727272727272727
brain challenge - nintendo ds,1,0,0,2,8,11,4.454545454545454
the crew wild run edition - playstation 4,0,0,1,2,8,11,4.636363636363637
bound by flame - playstation 3,0,0,5,3,3,11,3.8181818181818183
assassin's creed iv black flag limited edition - playstation 4,0,0,1,2,8,11,4.636363636363637
project snowblind - playstation 2,0,0,0,5,6,11,4.545454545454546
nightshade - playstation 2,0,0,4,4,3,11,3.909090909090909
nba live 16 - playstation 4,1,1,1,4,4,11,3.8181818181818183
psp 2 pack socom: fireteam bravo and syphon filter: dark mirror,0,0,1,0,10,11,4.818181818181818
evil dead: hail to the king,2,2,2,1,4,11,3.272727272727273
company of heroes: opposing fronts - pc,1,2,1,1,6,11,3.8181818181818183
dc universe online [download],3,1,3,2,2,11,2.909090909090909
gears of war 4: ultimate edition (includes steelbook with physical disc + season pass + early access) - xbox one,1,1,1,1,7,11,4.090909090909091
gba replacement battery cover,0,0,1,1,9,11,4.7272727272727275
spearhead expansion pack (medal of honor allied assault) - pc,0,0,3,2,6,11,4.2727272727272725
van helsing - playstation 2,0,0,1,2,8,11,4.636363636363637
tomb raider game of the year - playstation 3,3,0,0,2,6,11,3.727272727272727
final fantasy xi with hdd - playstation 2,1,2,2,4,2,11,3.3636363636363638
god of war iii,0,0,0,1,10,11,4.909090909090909
just dance 4 - playstation 3,1,0,0,0,10,11,4.636363636363637
xbox one 1tb console - ea sports madden nfl 16 bundle,3,0,0,2,6,11,3.727272727272727
robotech battlecry,1,0,1,6,3,11,3.909090909090909
gameboy color ac adapter,1,0,0,0,10,11,4.636363636363637
enchanted arms - xbox 360,2,2,4,3,0,11,2.727272727272727
nancy drew: the creature of kapu cave - pc,0,3,3,3,2,11,3.3636363636363638
tom clancy's ghost recon 2: first contact (greatest hits),2,4,3,0,2,11,2.6363636363636362
activision skylanders giants gnarly tree rex,1,0,2,1,7,11,4.181818181818182
disney infinity 3.0 editon: marvel's ultron figure,0,0,0,0,11,11,5.0
buzz jr.! jungle party bundle - playstation 2,0,0,1,5,5,11,4.363636363636363
spectral force 3 - xbox 360,5,1,0,2,3,11,2.727272727272727
doom: collector's edition - xbox one,1,0,1,2,7,11,4.2727272727272725
final fantasy xiv: a realm reborn (collector's edition) - playstation 4,0,1,1,1,8,11,4.454545454545454
for playstation ps vita (1st gen pch-100x not for silm version) aluminum brushed metal plated plastic crystal case skin protector cover + free screen protector,0,0,1,5,5,11,4.363636363636363
pikmin 2 (nintendo selects) - nintendo wii,0,0,0,1,10,11,4.909090909090909
family guy: back to the multiverse - xbox 360,1,1,3,2,4,11,3.6363636363636362
ghostbusters slimer fun pack - lego dimensions,0,0,2,0,9,11,4.636363636363637
grand kingdom - playstation 4,0,0,3,3,5,11,4.181818181818182
star wars: the force unleashed ii - pc,0,1,4,1,5,11,3.909090909090909
disney tangled - nintendo wii,0,0,3,3,5,11,4.181818181818182
hyperdimension neptunia (standard edition),1,0,3,3,4,11,3.8181818181818183
the sims 3: showtime - katy perry collector's expansion pack edition - pc,1,1,1,1,7,11,4.090909090909091
disney infinity 3.0 edition: marvel's black suit spider-man figure,0,0,0,1,10,11,4.909090909090909
james bond 007 agent under fire - xbox,1,0,3,3,4,11,3.8181818181818183
super mario sunshine,0,0,0,1,10,11,4.909090909090909
dark star one - broken alliance - xbox 360,1,1,2,2,5,11,3.8181818181818183
midnight club: la remix - sony psp,0,0,2,3,6,11,4.363636363636363
nintendo 3ds midnight purple - nintendo 3ds,0,0,2,1,8,11,4.545454545454546
world of warcraft 60 day game time [digital code] [online game code],0,0,1,0,10,11,4.818181818181818
battletoads,0,2,1,2,6,11,4.090909090909091
you are empty - pc,2,0,3,4,2,11,3.3636363636363638
tomb raider: the last revelation,1,1,0,2,7,11,4.181818181818182
the lord of the rings: shadows of angmar - pc,0,0,4,3,4,11,4.0
kapp'n amiibo - nintendo wii u,0,1,0,1,9,11,4.636363636363637
wwe smackdown vs. raw 2008 - playstation 3,0,1,3,3,4,11,3.909090909090909
majin and the forsaken kingdom - xbox 360,0,3,5,0,3,11,3.272727272727273
star fox (includes rumble pak),0,1,1,3,6,11,4.2727272727272725
lord of the rings: war in the north,1,2,1,3,4,11,3.6363636363636362
nba 2k16 - xbox 360,1,0,0,1,9,11,4.545454545454546
"insten dual charging station with 2 rechargeable batteries & led light for nintendo wii / wii u remote control, white controller charger dock - (original wii controllers not included) retail packaging",3,0,0,0,8,11,3.909090909090909
crash bandicoot: the huge adventure,0,0,0,4,7,11,4.636363636363637
final fantasy xii (collector's edition),0,0,0,3,8,11,4.7272727272727275
warriors orochi 3 hyper - nintendo wii u,0,0,2,0,9,11,4.636363636363637
skylanders swap force starter pack - nintendo wii u,0,0,0,1,10,11,4.909090909090909
cyber ? analog stick cover high type (for ps vita) black by cyber,0,0,2,2,7,11,4.454545454545454
drill dozer,0,0,0,5,6,11,4.545454545454546
wwf royal rumble,4,2,1,1,3,11,2.727272727272727
akiba's trip: undead & undressed - playstation 4,0,1,2,1,7,11,4.2727272727272725
anarchy online - pc,3,3,0,1,4,11,3.0
the witcher 3: wild hunt [online game code],0,0,1,2,8,11,4.636363636363637
thrillville: off the rails,0,1,1,6,3,11,4.0
eye of judgment,0,0,0,6,5,11,4.454545454545454
indiana jones and the emperor's tomb,1,2,1,5,2,11,3.4545454545454546
puzzler world - nintendo ds,1,0,1,2,7,11,4.2727272727272725
nightmare creatures,0,1,3,3,4,11,3.909090909090909
lego harry potter: years 5-7 - playstation 3,0,0,1,1,9,11,4.7272727272727275
rooms: the main building - nintendo ds,1,1,1,2,6,11,4.0
nintendo ds ac adapter,1,1,0,0,9,11,4.363636363636363
pdp titanfall 2 official marauder srs stereo headset for playstation 4,0,1,2,5,3,11,3.909090909090909
gaems g155 sentry personal gaming environment,1,2,0,1,7,11,4.0
shin megami tensei: strange journey - nintendo ds,0,0,1,2,8,11,4.636363636363637
parappa the rapper - sony psp,0,3,2,4,2,11,3.4545454545454546
dragon age inquisition - game of the year edition - xbox one,1,0,1,2,7,11,4.2727272727272725
batman returns,0,0,0,2,9,11,4.818181818181818
def jam icon - xbox 360,0,0,5,1,5,11,4.0
super ghouls 'n ghosts,0,0,1,4,6,11,4.454545454545454
skylanders swap force limited edition spring 2014 springtime trigger happy s3 character pack,0,0,1,0,10,11,4.818181818181818
thrustmaster tmx force feedback racing wheel for xbox one and windows,0,0,1,4,6,11,4.454545454545454
terraria - xbox one,2,1,2,3,3,11,3.3636363636363638
wii charger stat battery kit (colors may vary),0,2,0,1,8,11,4.363636363636363
wheel of fortune - playstation 2,1,1,0,2,7,11,4.181818181818182
guitar hero world tour,0,0,3,3,5,11,4.181818181818182
xbox 360 slim 250gb console,2,0,2,2,5,11,3.727272727272727
sonic the hedgehog genesis,3,2,1,1,4,11,3.090909090909091
disney infinity 3.0 edition: pixar's spot figure,1,0,1,1,8,11,4.363636363636363
pokemon trozei,0,2,1,5,3,11,3.8181818181818183
xbox 360 limited edition call of duty: modern warfare 3 bundle,0,1,0,0,10,11,4.7272727272727275
spore creature creator - pc/mac,2,0,2,2,5,11,3.727272727272727
riven: the sequel to myst - pc/mac,0,1,3,2,5,11,4.0
swat4: special weapons and tactics - pc,0,0,1,3,7,11,4.545454545454546
hde controller charger for sony playstation 3 controllers dual usb charging station for ps3 dualshock gamepads with led indicator lights,0,0,2,1,8,11,4.545454545454546
destiny: limited edition - xbox one,2,2,1,3,3,11,3.272727272727273
beyond good & evil,0,0,0,4,7,11,4.636363636363637
nintendogs dalmatian & friends,0,0,3,1,7,11,4.363636363636363
skylanders swap force starter pack - nintendo 3ds,0,0,0,1,10,11,4.909090909090909
back to the future,7,0,0,2,2,11,2.272727272727273
halo reach - limited edition -xbox 360,0,0,2,1,8,11,4.545454545454546
nhl 11 - playstation 3,1,1,2,1,6,11,3.909090909090909
tomee wii u protective case for gamepad - black,0,0,1,1,8,10,4.7
lego batman 2: dc super heroes - nintendo ds,0,0,1,3,6,10,4.5
ducktales: remastered [online game code],0,0,0,2,8,10,4.8
euro truck simulator 2 [download],0,0,0,4,6,10,4.6
skylanders spyro's adventure: wham-shell,0,0,1,0,9,10,4.8
turok 3: shadow of oblivion,0,2,2,2,4,10,3.8
the terminator: dawn of fate,0,2,2,3,3,10,3.7
need for speed rivals - xbox 360,0,1,3,1,5,10,4.0
the king of fighters xii - playstation 3,0,2,5,3,0,10,3.1
pro evolution soccer 2011 3d - nintendo 3ds,0,0,1,3,6,10,4.5
the sims 3: outdoor living stuff - pc/mac,2,0,1,1,6,10,3.9
activision skylanders giants 3 pack gill grunt flashwing double trouble,0,0,0,0,10,10,5.0
sega gt 2002 - xbox,1,1,2,1,5,10,3.8
hyperdevotion noire: goddess black heart,0,0,2,1,7,10,4.5
nhl 10 - xbox 360,0,0,3,2,5,10,4.2
udraw game tablet with udraw studio: instant artist - xbox 360,1,3,2,0,4,10,3.3
star wars episode 1: battle for naboo,1,1,1,3,4,10,3.8
xbr depot deluxe unlock special open tool kit  screwdriver set complete xbox 360 disassembly with torx t8 and torx t10,0,0,2,1,7,10,4.5
deus ex human revolution - augmented edition -xbox 360,0,0,0,0,10,10,5.0
nhl 12 - xbox 360,0,1,1,2,6,10,4.3
elder scrolls v: skyrim collector's edition -xbox 360,2,0,0,0,8,10,4.2
sherlock holmes: crimes & punishments - xbox one,1,0,1,5,3,10,3.9
magna carta 2 - xbox 360,0,0,0,3,7,10,4.7
shift 2 - unleashed - pc (limited),2,1,1,2,4,10,3.5
ufc undisputed 2010 - xbox 360,0,2,0,2,6,10,4.2
tom clancy's ghost recon future soldier [download],0,2,1,4,3,10,3.8
skylanders spyro's adventure pack - darklight crypt,0,0,0,1,9,10,4.9
wwe smackdown vs. raw 2011,1,1,2,2,4,10,3.7
exerbeat - nintendo wii,0,0,0,3,7,10,4.7
activision skylanders giants 3 pack sonic boom sprocket stump smash,0,0,0,0,10,10,5.0
memory card for nintendo 64,1,0,0,0,9,10,4.6
two worlds ii official strategy guide,0,2,2,3,3,10,3.7
kmd komodo shockwave wireless black controller,1,0,1,3,5,10,4.1
skylanders giants jade flashwing,1,0,0,2,7,10,4.4
fallout 3 game add-on pack: operation anchorage and the pitt - pc,1,0,1,4,4,10,4.0
nintendo dsi xl - metallic rose,0,0,0,2,8,10,4.8
asphalt: injection - playstation vita,0,0,3,2,5,10,4.2
the thing,1,0,3,4,2,10,3.6
cars 2: the video game - nintendo wii,0,0,3,3,4,10,4.1
dungeon hunter alliance - playstation vita,1,2,2,1,4,10,3.5
nhl 12 - playstation 3,0,1,1,2,6,10,4.3
soldier of fortune (gold edition),3,1,2,2,2,10,2.9
backbreaker football - xbox 360,1,0,4,4,1,10,3.4
gothic - pc,0,2,3,1,4,10,3.7
michael jackson the experience - playstation vita,0,0,3,1,6,10,4.3
etrian odyssey iii: the drowned city - nintendo ds,0,0,3,0,7,10,4.4
"nintendo wii u pro u controller (japanese version), black",1,1,0,1,7,10,4.2
lego pirates of the caribbean - nintendo ds,0,0,1,1,8,10,4.7
donop 9 pairs x thumbstick stick grip case for ps4 playstation 4 ps2 ps3 xbox 360 wii controller--9 colors,0,0,0,0,10,10,5.0
tetris worlds,2,0,1,3,4,10,3.7
sonic shuffle,1,2,0,2,5,10,3.8
dtol wii motion plus adapter (white),0,0,1,1,8,10,4.7
call of duty advanced warfare - day zero edition - ps3,1,0,2,1,6,10,4.1
vietcong - pc,0,1,4,2,3,10,3.7
call of duty: ghosts hardened edition - xbox one,0,1,1,0,8,10,4.5
hot shots tennis: get a grip,0,0,1,4,5,10,4.4
omega quintet,0,2,1,1,6,10,4.1
the evil within - pc,0,2,0,3,5,10,4.1
saw - xbox 360,1,0,3,3,3,10,3.7
ride to hell retribution,2,3,2,1,2,10,2.8
max payne 3: special edition -xbox 360,0,0,0,2,8,10,4.8
dead to rights: retribution - xbox 360,0,1,3,5,1,10,3.6
alan wake [download],0,2,1,1,6,10,4.1
escape from monkey island,0,1,2,1,6,10,4.2
one piece: unlimited world: day one edition - nintendo 3ds,0,0,0,1,9,10,4.9
napoleon total war limited edition - pc,2,0,0,2,6,10,4.0
green lantern: rise of the manhunters - nintendo 3ds,0,2,3,1,4,10,3.7
jewel master egypt - nintendo ds,0,1,2,2,5,10,4.1
star wars: super bombad racing,0,2,3,1,4,10,3.7
wwf royal rumble,0,0,2,3,5,10,4.3
cirka controller for n64 (green),1,1,0,1,7,10,4.2
madden 2002,0,0,1,5,4,10,4.3
marvel ultimate alliance 2 - nintendo wii,0,1,2,2,5,10,4.1
nba 2k2 (playstation 2),0,0,0,4,6,10,4.6
microsoft combat flight simulator 2:  pacific theater - pc,0,0,2,2,6,10,4.4
the longest journey: adventure game of the year edition - pc,0,0,2,4,4,10,4.2
skylanders giants pumpkin eye brawl special halloween 2013 edition,2,1,2,2,3,10,3.3
star wars starfighter special edition,0,1,5,0,4,10,3.7
amnesia: the dark descent - pc,0,0,2,3,5,10,4.3
skylanders spyro's adventure: stump smash,1,0,0,2,7,10,4.4
mortal kombat advance,6,2,1,1,0,10,1.7
primal rage - nintendo super nes,0,2,3,1,4,10,3.7
serious sam,0,0,1,2,7,10,4.6
hometown story - nintendo 3ds,2,1,2,2,3,10,3.3
kessen,1,1,1,1,6,10,4.0
nfl 2k1,0,0,0,2,8,10,4.8
ninja gaiden trilogy,0,1,1,1,7,10,4.4
dreamland [download],0,1,0,6,3,10,4.1
"turtle beach ear force px4 premium wireless gaming headset with dolby surround sound and ps4 talkback cable for playstation 4, playstation 3, xbox 360 and mobile devices",1,0,0,4,5,10,4.2
sennheiser x2 xbox headset,0,2,2,4,2,10,3.6
star wars demolition,1,0,2,3,4,10,3.9
xbox 360 modern warfare 2 limited edition console,0,0,1,1,8,10,4.7
sniper elite v2 - nintendo wii u,0,0,1,1,8,10,4.7
medievil 2,0,1,1,4,4,10,4.1
xbox 360 250gb holiday value bundle with kinect,0,0,0,2,8,10,4.8
tales of hearts r (psvita),0,0,2,3,5,10,4.3
skylanders spyro's adventure: stealth elf,0,0,0,2,8,10,4.8
fairy fencer f - playstation 3,1,0,1,2,6,10,4.2
just dance kids 2014,0,1,1,4,4,10,4.1
resident evil gaiden,1,3,1,2,3,10,3.3
lego the hobbit - nintendo 3ds,0,0,0,0,10,10,5.0
activision anthology - playstation 2,0,0,1,5,4,10,4.3
air conflicts: vietnam - playstation 4,0,3,3,1,3,10,3.4
nintendo wii u gamepad accessory set,0,0,0,1,9,10,4.9
sid meier's simgolf - pc,1,0,1,4,4,10,4.0
racquet sports - playstation 3,1,2,2,2,3,10,3.4
sonic all star racing - nintendo ds,0,0,2,2,6,10,4.4
flip travel charger for nintendo ds lite,1,0,1,2,6,10,4.2
rock band 3,0,1,0,0,9,10,4.7
arcania: gothic 4 - xbox 360,0,1,1,5,3,10,4.0
ps3 250gb amazon exclusive family entertainment bundle,0,0,0,1,9,10,4.9
blades of time - playstation 3,2,3,1,2,2,10,2.9
hunted: the demon's forge - pc,0,2,5,1,2,10,3.3
rock band 3 wireless fender mustang pro-guitar controller for playstation 3,1,1,1,2,5,10,3.9
the sims medieval: pirates and nobles - pc/mac,1,1,1,2,5,10,3.9
the king of fighters xiii - xbox 360,0,1,0,0,9,10,4.7
rumble racing,0,0,2,3,5,10,4.3
lego indiana jones 2: the adventure continues - nintendo wii,0,3,1,0,6,10,3.9
amped: freestyle snowboarding,0,0,3,3,4,10,4.1
powera charging station for xbox one,0,1,0,2,7,10,4.5
gears of war: judgment,0,1,4,4,1,10,3.5
100% hidden objects [download],0,1,1,3,5,10,4.2
nes advantage joystick,0,0,0,2,8,10,4.8
super street fighter iv arcade edition - pc,0,1,0,3,6,10,4.4
ncaa football 2003,0,1,1,0,8,10,4.5
super mario rpg: legend of the seven stars - wii u [digital code],0,0,0,1,9,10,4.9
virtua tennis 4 - playstation 3,1,0,2,2,5,10,4.0
skylanders giants: lightcore eruptor character,0,0,1,0,9,10,4.8
the longest journey - pc,0,1,1,5,3,10,4.0
major league baseball 2k12 - playstation 3,1,1,3,1,4,10,3.6
nyko core controller - wired controller alternative with analog face buttons and joystick for playstation 3,2,0,1,4,3,10,3.6
star wars rebel assault ii: the hidden empire,0,1,0,1,8,10,4.6
castlevania bloodlines,0,0,0,3,7,10,4.7
the biggest loser ultimate workout - xbox 360,1,2,1,3,3,10,3.5
resident evil: revelations 2 - xbox 360,2,0,2,2,4,10,3.6
trinity universe - playstation 3,0,1,3,1,5,10,4.0
sid meier's civilization: beyond earth [online game code],0,2,3,3,2,10,3.5
no one lives forever - pc,0,0,1,3,6,10,4.5
twisted metal: black,0,0,1,2,7,10,4.6
fuse - xbox 360,0,0,1,7,2,10,4.1
tetris & dr. mario - 2 game cartridge,0,0,0,1,9,10,4.9
shin megami tensei: devil survivor 2 - nintendo ds,0,0,1,1,8,10,4.7
dark angel: vampire apocalypse - playstation 2,4,3,1,0,2,10,2.3
jak & daxter: the lost frontier - playstation 2,1,2,2,3,2,10,3.3
command & conquer: renegade - pc,1,0,2,3,4,10,3.9
planetside - pc,0,2,2,3,3,10,3.7
f1: 2010 - xbox 360,0,1,2,0,7,10,4.3
nhl 14 - xbox 360,0,0,2,2,6,10,4.4
atelier escha & logy: alchemists of the dusk sky - playstation 3,1,0,0,1,8,10,4.5
tao feng: fist of the lotus,1,1,1,2,5,10,3.9
star wars jedi starfighter - xbox,0,2,2,2,4,10,3.8
dead or alive 5 ultimate - xbox 360,1,0,1,0,8,10,4.4
castlevania: lords of shadow - playstation 3 (limited edition),1,0,0,0,9,10,4.6
system shock 2 - pc,1,1,0,2,6,10,4.1
street fighter ii turbo: hyper fighting,0,0,0,2,8,10,4.8
lara croft tomb raider: the angel of darkness,1,1,5,2,1,10,3.1
carrying case for nintendo 2ds console - blue,0,0,0,2,8,10,4.8
the sims 3 [download],1,0,1,0,8,10,4.4
call of duty: advanced warfare atlas pro edition - playstation 4,0,1,1,1,7,10,4.4
rune - pc,1,1,2,4,2,10,3.5
lego the hobbit - xbox 360,0,0,2,2,6,10,4.4
sega smash pack volume 1,0,0,3,3,4,10,4.1
nintendo super smash bros. white classic gamecube controller,0,0,0,1,9,10,4.9
dream chronicles - nintendo ds,2,0,5,1,2,10,3.1
mass effect 3 collector's edition - pc,2,0,2,3,3,10,3.5
attack of the movies 3d - nintendo wii,0,3,2,3,2,10,3.4
spy hunter - playstation 2,0,0,2,3,5,10,4.3
legends of wrestling,2,0,5,2,1,10,3.0
los cuatro fantasticos,0,3,0,5,2,10,3.6
tron: evolution - xbox 360,0,1,5,1,3,10,3.6
deadfall adventures - xbox 360,1,1,3,1,4,10,3.6
star trek: bridge commander,0,0,4,3,3,10,3.9
morphx - xbox 360,2,0,2,2,4,10,3.6
grand theft auto v - pc download [download],2,1,1,3,3,10,3.4
game of thrones,1,4,2,0,3,10,3.0
zoo tycoon xbox one,0,2,1,2,5,10,4.0
skylanders spyro's adventure: cynder,1,0,0,2,7,10,4.4
the simpsons skateboarding,4,2,1,2,1,10,2.4
tetris party deluxe - nintendo wii,0,2,0,1,7,10,4.3
sacred 3 - playstation 3,2,1,2,1,4,10,3.4
need for speed: hot pursuit 2,0,1,0,4,5,10,4.3
star tropics ii: zoda's revenge,0,0,1,3,6,10,4.5
xbox 360 black headset,0,1,2,1,6,10,4.2
majesco zumba fitness belt for wii,0,0,2,3,5,10,4.3
the black eyed peas experience - xbox 360,0,0,0,1,9,10,4.9
horipad pro for xbox one officially licensed controller,1,0,1,2,6,10,4.2
high velocity bowling (motion control) - playstation 3,1,1,0,4,4,10,3.9
samurai shodown sen - xbox 360,3,1,1,0,5,10,3.3
nancy drew: ghost of thornton hall - pc/mac,0,0,2,4,4,10,4.2
twisted lands: insomniac [download],0,0,2,5,3,10,4.1
your shape - nintendo wii,3,0,2,3,2,10,3.1
xbox 360 kinect wall mount,0,0,1,1,8,10,4.7
playstation 2 vertical console stand,1,0,3,1,5,10,3.9
batman: arkham knight - limited edition - xbox one,0,0,1,1,8,10,4.7
hakuoki: demon of the fleeting blossom limited edition - sony psp,0,0,0,3,7,10,4.7
amazonbasics wheel for nintendo wii (officially licensed by nintendo),0,0,4,3,3,10,3.9
evolution worlds,0,0,2,6,2,10,4.0
datel action replay cheat system (3ds/dsi xl/dsi/ds lite),3,0,0,2,5,10,3.6
jojo's bizarre adventure: all-star battle - playstation 3,1,0,0,2,7,10,4.4
batman: arkham knight - playstation 4,1,0,0,3,6,10,4.3
wii band hero featuring taylor swift - super bundle,0,1,0,1,8,10,4.6
age of empires 2 official expansion: the conquerors - pc,0,0,0,2,8,10,4.8
wolfenstein: the new order [online game code],0,0,3,1,6,10,4.3
lego lord of the rings - nintendo ds,0,1,0,2,7,10,4.5
alien: isolation [online game code],0,2,1,1,6,10,4.1
overlord 2,0,0,2,1,7,10,4.5
baja: edge of control - playstation 3,0,0,2,4,4,10,4.2
resident evil 5 - standard edition - xbox one,0,0,0,3,7,10,4.7
tony hawk's underground - gamecube,0,0,0,2,8,10,4.8
time splitters: future perfect - xbox,0,1,1,1,7,10,4.4
fuzion frenzy 2 - xbox 360,1,4,3,2,0,10,2.6
star wars episode i: the phantom menace,0,1,0,1,8,10,4.6
fifa 16 - standard edition - playstation 3,0,0,1,0,9,10,4.8
cars - nintendo wii,0,1,4,1,4,10,3.8
zero suit samus amiibo - japan import (super smash bros series),0,0,0,0,10,10,5.0
order up!,0,0,1,5,4,10,4.3
playstation 2 eye toy,1,1,1,1,6,10,4.0
far cry: vengeance - nintendo wii,2,5,1,2,0,10,2.3
atelier iris eternal mana - playstation 2,0,2,2,4,2,10,3.6
thrillville - playstation 2,0,0,1,2,7,10,4.6
moe chronicle (english subtitles) - ps vita,0,0,1,1,8,10,4.7
disney infinity 3.0 edition: time figure - not machine specific,1,1,0,3,5,10,4.0
ghostbusters - playstation 4,4,1,1,0,4,10,2.9
guitar hero (game only),0,0,2,1,7,10,4.5
sphinx and the cursed mummy,0,0,1,2,7,10,4.6
kill switch,0,1,2,2,5,10,4.1
family guy - playstation 2 (collector's),1,2,3,2,2,10,3.2
soul blade,0,0,2,2,6,10,4.4
persona 4: dancing all night - playstation vita standard edition edition,0,0,1,3,6,10,4.5
guitar hero 2,0,0,1,3,6,10,4.5
crimson sea 2 - playstation 2,0,1,1,4,4,10,4.1
space invaders extreme - sony psp,0,0,2,3,5,10,4.3
midway arcade treasures,0,0,0,5,5,10,4.5
psp traveler case,1,1,2,2,4,10,3.7
armed and dangerous,0,0,0,7,3,10,4.3
mystery case files: prime suspects - pc,0,0,0,1,9,10,4.9
disney infinity 3.0 edition: marvel battlegrounds power disc pack,0,1,0,0,9,10,4.7
mortal kombat xl - xbox one,0,0,0,1,9,10,4.9
spongebob squarepants: the battle for bikini bottom - gamecube,1,0,0,0,9,10,4.6
hori amiibo collect and display case for nintendo amiibo figures,0,0,0,0,10,10,5.0
elebits - nintendo wii,0,0,2,3,5,10,4.3
caesar iii,0,0,0,4,6,10,4.6
nintendo animal crossing: happy home designer + new 3ds bundle,0,0,0,0,10,10,5.0
espn nfl football - xbox,0,0,1,1,8,10,4.7
mega man star force 2 zerker x saurian - nintendo ds,0,0,0,4,6,10,4.6
motorstorm: arctic edge - sony psp,0,0,1,1,8,10,4.7
skylanders superchargers starter pack - playstation 4,1,0,1,1,7,10,4.3
lego star wars: the force awakens - wii u standard edition,0,0,0,2,8,10,4.8
"pdp energizer ps4 controller charger with rechargeable lithium batteries for two wireless controllers charging station 051-037, deluxe",0,1,0,1,8,10,4.6
etrian odyssey - nintendo ds,0,0,3,1,6,10,4.3
xcom 2 - pc,2,1,0,4,3,10,3.5
baja: edge of control - xbox 360,2,2,2,2,2,10,3.0
incredible hulk: ultimate destruction,0,0,2,4,4,10,4.2
phantom dust,0,0,0,3,7,10,4.7
psychonauts - xbox,0,0,0,1,9,10,4.9
rogue trooper,1,0,2,4,3,10,3.8
medal of honor: allied assault breakthrough expansion pack - pc,1,0,3,4,2,10,3.6
dreamfall: the longest journey - xbox,0,0,1,4,5,10,4.4
nascar heat evolution (ps4) - playstation 4,2,0,3,1,4,10,3.5
star wars battlefront elite squadron - sony psp,0,0,2,3,5,10,4.3
metal slug anthology - sony psp,0,0,0,1,9,10,4.9
faxanadu,0,0,0,2,8,10,4.8
star trek - legacy - pc,3,3,3,0,1,10,2.3
temple of elemental evil: a classic greyhawk adventure - pc,2,2,1,4,1,10,3.0
pillars of eternity hero edition [online game code],0,1,4,0,5,10,3.9
agents of mayhem - playstation 4,0,2,2,1,5,10,3.9
atelier sophie: the alchemist of the mysterious book - playstation 4,0,0,1,3,6,10,4.5
titanfall 2 deluxe edition - xbox one,0,0,0,1,9,10,4.9
onechanbara: bikini zombie slayers - nintendo wii,0,1,1,3,5,10,4.2
blazblue: chrono phantasma extend - xbox one,0,1,1,1,7,10,4.4
king of fighters collection- the orochi saga - playstation 2,0,0,2,2,6,10,4.4
pdp legendary collection sound of justice true wireless headset for xbox one,0,0,3,3,4,10,4.1
pdp wired controller for xbox one & pc - camo,0,0,1,3,6,10,4.5
nhl 17 - playstation 4,2,3,1,0,4,10,3.1
ori and the blind forest - xbox one digital code,1,0,0,0,9,10,4.6
sonic riders - playstation 2,0,2,0,2,6,10,4.2
jurassic park,1,0,2,2,5,10,4.0
cate west the vanishing files - nintendo ds,1,1,0,3,5,10,4.0
sid meier's civilization vi - pc,1,0,0,3,6,10,4.3
mighty no. 9 - xbox one,0,0,4,1,5,10,4.1
cruis'n world,1,0,1,3,5,10,4.1
madagascar - playstation 2,0,0,1,3,6,10,4.5
adjustr + headset for ps4,0,1,6,2,1,10,3.3
valkyrie profile: lenneth,0,0,2,3,5,10,4.3
fantastic four - playstation 2,2,2,0,2,4,10,3.4
sonic rivals - sony psp,0,1,3,1,5,10,4.0
nintendo ds lite protective filter,1,0,0,4,5,10,4.2
dragonball z budokai tenkaichi 2 - playstation 2,0,0,0,1,9,10,4.9
touch detective - nintendo ds,0,0,4,3,3,10,3.9
pac pix - nintendo ds,1,1,1,3,4,10,3.8
lord of the rings: conquest - playstation 3,0,2,2,1,5,10,3.9
naruto: ultimate ninja - playstation 2,0,1,0,4,5,10,4.3
god eater 2: rage burst - playstation 4 day 1 edition,1,2,1,1,5,10,3.7
wolfenstein: the old blood - ps4 [digital code],0,0,1,4,5,10,4.4
hatsune miku: project diva x - playstation 4,0,0,0,3,7,10,4.7
ncaa football 2007 - xbox 360,2,1,5,1,1,10,2.8
steel 4.5mm screwdriver security bit open snes n64 gamecube game consoles + genesis master system games,2,0,1,1,6,10,3.9
madden nfl 16 - xbox 360,1,0,0,1,8,10,4.5
duke nukem: time to kill,0,0,1,2,7,10,4.6
"steelseries siberia p300 comfortable gaming headset for playstation 4, playstation 3",0,0,0,6,4,10,4.4
disney infinity 3.0 edition: star wars twilight of the republic power disc pack,0,0,0,0,10,10,5.0
superman,8,0,1,0,1,10,1.6
ncaa football 2005,1,0,1,0,8,10,4.4
mercenaries 2: world in flames - pc,0,1,3,2,4,10,3.9
kirby and the amazing mirror,0,0,0,1,9,10,4.9
mercenaries 2: world in flames - playstation 2,2,2,1,0,5,10,3.4
pdp afterglow ag 9 wireless headset for xbox one,0,0,1,3,6,10,4.5
mah jong quest expeditions,0,0,1,5,4,10,4.3
thrustmaster t-wireless gamepad for nintendo wii,0,2,2,2,4,10,3.8
fallout anthology - pc,2,0,0,1,7,10,4.1
donkey kong country 2,0,0,1,1,8,10,4.7
harry potter and the prisoner of azkaban - playstation 2,0,1,2,1,6,10,4.2
hot shots golf fore - playstation 2,0,0,1,1,8,10,4.7
"warhammer 40,000: dawn of war - pc",0,1,0,3,6,10,4.4
tom clancy's splinter cell: chaos theory - pc,0,0,2,3,5,10,4.3
divinity: original sin - enhanced edition - playstation 4,0,0,0,1,9,10,4.9
e.t. the extra-terrestrial,1,1,3,1,4,10,3.6
time crisis 4 (includes guncon 3) - playstation 3,0,1,1,4,4,10,4.1
hori battle pad for wii u (link version) with turbo - nintendo wii u,1,0,0,1,8,10,4.5
tiger woods pga tour 08 - xbox 360,1,0,3,2,4,10,3.8
disney infinity 3.0: inside out toy bundle - amazon exclusive,0,0,1,1,8,10,4.7
madden nfl 08 - nintendo wii,0,3,2,5,0,10,3.2
skate - playstation 3,1,0,1,4,4,10,4.0
thief: the dark project - pc,1,0,0,2,7,10,4.4
killer 7 - gamecube,0,0,0,5,5,10,4.5
mega man zx: advent,0,1,0,2,7,10,4.5
code breaker for playstation 2,1,1,1,2,5,10,3.9
the legend of spyro: the eternal night,2,2,1,0,5,10,3.4
n+ - nintendo ds,0,0,2,4,4,10,4.2
mx vs atv untamed - xbox 360,0,0,1,2,7,10,4.6
trauma center: new blood - nintendo wii,1,0,3,4,2,10,3.6
back to the future: the game - 30th anniversary edition - xbox one,1,0,0,3,6,10,4.3
game of thrones - a telltale games series - playstation 4,0,1,1,2,6,10,4.3
arslan: the warriors of legend - playstation 4,1,0,2,4,3,10,3.8
lord of the rings the third age - gamecube,0,1,3,3,3,10,3.8
spongebob squarepants: atlantis squarepantis - nintendo ds,0,0,3,1,6,10,4.3
"playstation 3 / ps3 / xbox360 console dust cover gaming system protector [antistatic, water resistant, premium fabric, black] by digitaldeckcovers",1,0,0,0,9,10,4.6
cyber gadget rubber coating grip 2 black for nintendo new 3ds ll xl,0,0,0,4,6,10,4.6
skylanders superchargers: vehicle sky slicer character pack,0,0,0,0,10,10,5.0
need for speed: prostreet - nintendo wii,0,1,1,5,3,10,4.0
skylanders superchargers: vehicle crypt crusher character pack,0,0,0,0,10,10,5.0
grand theft auto iv special edition - playstation 3,0,0,1,2,7,10,4.6
dynasty warriors: gundam - xbox 360,0,2,2,3,3,10,3.7
bluwave infrared remote - playstation 3,0,1,1,4,4,10,4.1
ebotrade-tech dual wii remote usb charging station with battery packs,1,0,2,1,6,10,4.1
neverwinter nights 2 expansion pack: mask of the betrayer - pc,0,0,1,4,5,10,4.4
viewtiful joe 2 - playstation 2,0,0,1,2,7,10,4.6
sony playstation video game console,1,0,1,1,7,10,4.3
shellshock 2: blood trails - xbox 360,4,1,4,0,1,10,2.3
chibi-robo!: zip lash - nintendo 3ds standard edition,0,0,2,5,3,10,4.1
legendary - pc,6,0,0,0,4,10,2.6
eboot wall power ac charger adapter for nintendo wii u gamepad,0,0,0,1,9,10,4.9
space siege - pc,0,4,3,2,1,10,3.0
the chronicles of narnia: prince caspian - playstation 3,2,2,2,0,4,10,3.2
teenage mutant ninja turtles: fall of the foot clan,0,0,1,5,4,10,4.3
wonder world amusement park,4,2,0,0,4,10,2.8
zenses: ocean edition - nintendo ds,0,2,0,0,8,10,4.4
nba street homecourt - playstation 3,0,1,2,1,6,10,4.2
mighty morphin power rangers,0,0,2,2,6,10,4.4
disney infinity 3.0 edition: marvel's black panther figure,0,0,1,0,9,10,4.8
marvel ultimate alliance gold edition -xbox 360,0,0,0,1,9,10,4.9
tmnt - playstation 2,0,1,3,2,4,10,3.9
the simcity box - pc,2,2,4,2,0,10,2.6
leisure suit larry: box office bust - xbox 360,5,0,0,2,3,10,2.8
mad catz hd component cable for wii and wii u,0,0,1,1,8,10,4.7
disney infinity 3.0 edition: disney pixar's fear figure,0,0,0,0,10,10,5.0
nintendo selects: yoshi's new island,0,0,2,0,8,10,4.6
disney infinity 3.0 edition: minnie mouse figure,0,0,0,1,9,10,4.9
myst - pc,0,2,2,1,5,10,3.9
nfl street 2 - playstation 2,0,0,1,0,9,10,4.8
tna impact! - playstation 2,3,2,0,0,5,10,3.2
fatal fury battle archives vol 2 - playstation 2,0,0,0,4,6,10,4.6
shadow ops red mercury - xbox,0,1,1,1,7,10,4.4
medal of honor: vanguard - nintendo wii,0,0,1,4,5,10,4.4
bomberman land - nintendo wii,0,2,2,4,2,10,3.6
final doom,0,0,2,3,5,10,4.3
x-men legends - xbox,0,0,3,2,5,10,4.2
tales of the world: radiant mythology,0,2,2,1,5,10,3.9
mvp baseball 2004,3,1,0,3,3,10,3.2
hitman contracts - playstation 2,0,1,1,4,4,10,4.1
medal of honor allied assault war chest - pc,0,0,1,0,9,10,4.8
hitman contracts - pc,0,1,2,3,4,10,4.0
drakengard - playstation 2,0,0,3,2,5,10,4.2
dishonored definitive edition - xbox one,0,0,2,0,8,10,4.6
sonic advance 3,0,0,1,6,3,10,4.2
hitman: the complete first season - xbox one,1,1,0,2,6,10,4.1
sonic battle,0,0,2,2,6,10,4.4
nintendo wii high resolution av / hdtv / edtv component cable (bulk packaging),0,0,1,4,5,10,4.4
philips sgp5012 retractable ac/dc charger for nintendo ds ds lite & sony psp,0,0,0,6,4,10,4.4
battlefield: bad company gold edition - playstation 3,0,0,0,2,8,10,4.8
wwf attitude,0,1,2,2,5,10,4.1
destiny: the taken king - legendary edition - playstation 3,1,0,1,1,7,10,4.3
cold winter - playstation 2,0,0,0,6,4,10,4.4
half-life - pc,1,0,1,3,5,10,4.1
rock band game only ps3,0,0,2,2,6,10,4.4
grand theft auto: san andreas,0,0,0,5,5,10,4.5
battalion wars - gamecube,0,1,1,3,5,10,4.2
pdp battlefield 1 official wired controller for xbox one & windows,0,0,0,3,7,10,4.7
50 cent: bulletproof - playstation 2,2,0,1,3,4,10,3.7
tony hawk's american wasteland - playstation 2,0,0,1,3,6,10,4.5
galactic civilizations 2: dread lords - pc,1,0,1,2,6,10,4.2
fallout 3 game add-on pack: broken steel and point lookout,0,0,1,3,6,10,4.5
lost in blue - nintendo ds,0,0,3,2,5,10,4.2
tom clancy's ghost recon: advanced warfighter - pc,3,1,1,3,2,10,3.0
donkey kong land,0,1,2,2,5,10,4.1
wii dance dance revolution dance pad controller,0,0,1,1,8,10,4.7
ultimate spider-man,0,1,1,5,3,10,4.0
quake 4: special dvd edition,2,0,1,4,3,10,3.6
vandal hearts,0,0,0,4,6,10,4.6
buffy the vampire slayer: chaos bleeds - playstation 2,1,0,2,3,4,10,3.9
hori battle pad for wii u pikachu version with turbo,1,0,0,0,9,10,4.6
teenage mutant ninja turtles: tournament fighters,0,0,2,2,6,10,4.4
gardening mama - nintendo ds,0,0,2,2,6,10,4.4
xbox one s 1tb console - madden nfl 17 bundle [discontinued],1,0,0,1,8,10,4.5
gauntlet seven sorrows - xbox,1,3,0,2,4,10,3.5
nintendo donkey kong amiibo (sm series) - nintendo wii u,0,0,0,0,10,10,5.0
pdp titanfall 2 official marauder six four communicator for  playstation 4,0,1,5,2,2,10,3.5
midway arcade treasures extended play,2,0,0,3,5,10,3.9
patapon 2 (downloadable game voucher) - sony psp,1,1,0,2,6,10,4.1
recore collectors edition - xbox one,1,0,1,2,6,10,4.2
logitech usb vantage headset for playstation 2 and playstation3,1,1,2,2,4,10,3.7
eat lead: the return of matt hazard,2,3,1,2,2,10,2.9
call of duty: modern warfare 2 hardened edition - playstation 3,0,0,0,1,9,10,4.9
xbox 360 wireless controller - white,0,0,1,2,7,10,4.6
g.i. joe: the rise of cobra - playstation 3,3,0,2,0,5,10,3.4
naruto shippuden: ultimate ninja storm 4 - xbox one,1,0,1,0,8,10,4.4
rock band unplugged - sony psp,1,0,1,4,3,9,3.888888888888889
the hobbit - playstation 2,2,0,0,1,6,9,4.0
mystery case files: 13th skull collector's edition,0,0,0,0,9,9,5.0
mystery p.i.: the london caper,0,0,1,1,7,9,4.666666666666667
extreme-g 3,0,1,3,2,3,9,3.7777777777777777
dragon age 2 - bioware signature edition - pc,1,1,4,0,3,9,3.3333333333333335
solitaire overload - nintendo ds,2,0,0,0,7,9,4.111111111111111
the sims - the people simulator from the creator of simcity,0,0,1,0,8,9,4.777777777777778
dark souls: collector's edition,0,2,0,3,4,9,4.0
game of thrones - xbox 360,1,1,2,0,5,9,3.7777777777777777
midnight mysteries 2: salem witch trials,1,0,0,2,6,9,4.333333333333333
vigilante 8,0,1,3,1,4,9,3.888888888888889
"gabriel knight 3: blood of the sacred, blood of the damned - pc",0,1,2,5,1,9,3.6666666666666665
oddworld abe's oddysee,0,0,0,0,9,9,5.0
x-blades - playstation 3,1,2,0,5,1,9,3.3333333333333335
far cry primal - pc standard edition,1,3,0,1,4,9,3.4444444444444446
playstation 3 intercooler,4,2,0,2,1,9,2.3333333333333335
sega master system 1 - video game console,0,0,3,0,6,9,4.333333333333333
sims bustin' out - gamecube,0,0,2,0,7,9,4.555555555555555
xbox one 1tb console - tom clancy's the division bundle,0,1,0,1,7,9,4.555555555555555
overlord 2 - pc,2,1,2,2,2,9,3.111111111111111
dragon ball: raging blast 2 - xbox 360,0,1,0,1,7,9,4.555555555555555
star trek elite force 2 - pc,0,0,1,6,2,9,4.111111111111111
tiger woods pga tour 13 - xbox 360,0,1,2,0,6,9,4.222222222222222
"steelseries siberia p100 comfortable gaming headset for playstation 4, playstation 3",0,0,0,4,5,9,4.555555555555555
bust-a-move bash!,0,3,4,1,1,9,3.0
mech assault 2 lone wolf - xbox,0,1,0,3,5,9,4.333333333333333
myst v: end of ages - pc,0,2,3,2,2,9,3.4444444444444446
tomb raider pc,0,1,0,2,6,9,4.444444444444445
street fighter x tekken: special edition - playstation 3,0,1,4,1,3,9,3.6666666666666665
star wars jedi knight: jedi academy (jewel case) - pc,0,0,0,2,7,9,4.777777777777778
officially licensed ps2 wireless controller - silver,0,0,2,4,3,9,4.111111111111111
stronghold 3 gold [download],5,1,2,0,1,9,2.0
disney infinity 3.0 edition: marvel's ant-man figure,0,1,0,0,8,9,4.666666666666667
the last remnant - pc,1,0,4,2,2,9,3.4444444444444446
disney infinity 3.0 edition: marvel's vision figure,0,0,0,0,9,9,5.0
comix zone,0,1,1,3,4,9,4.111111111111111
fallout,0,1,3,2,3,9,3.7777777777777777
dungeon defenders [download],1,2,0,2,4,9,3.6666666666666665
ssx blur - nintendo wii,0,2,2,0,5,9,3.888888888888889
madden nfl 15 (ultimate edition) - xbox one,2,0,0,3,4,9,3.7777777777777777
rock band 4 wireless guitar bundle- xbox one,1,0,2,3,3,9,3.7777777777777777
myst - nintendo ds,0,4,3,0,2,9,3.0
predator concrete jungle - xbox,0,1,3,4,1,9,3.5555555555555554
battlefield 1 exclusive collector's edition - does not include game,1,0,0,3,5,9,4.222222222222222
sonic generations [download],0,0,1,3,5,9,4.444444444444445
g-force - sony psp,0,0,0,2,7,9,4.777777777777778
the sims 2: castaway - nintendo ds,0,0,1,5,3,9,4.222222222222222
the sims 3: pets - playstation 3,1,1,0,3,4,9,3.888888888888889
dragonball z sagas - playstation 2,0,0,3,2,4,9,4.111111111111111
cake mania nds,0,1,2,3,3,9,3.888888888888889
disney infinity 3.0 edition: olaf figure,0,0,0,0,9,9,5.0
red dead redemption,1,0,0,1,7,9,4.444444444444445
summoner,0,1,2,3,3,9,3.888888888888889
need for speed underground - pc,0,1,2,3,3,9,3.888888888888889
star wars: battlefront ii,0,0,0,2,7,9,4.777777777777778
assassin's creed chronicles - xbox one standard edition,1,0,1,4,3,9,3.888888888888889
evil dead regeneration - xbox,0,0,0,2,7,9,4.777777777777778
little big planet 3 plush edition - playstation 4,0,1,1,1,6,9,4.333333333333333
crash bandicoot: the wrath of cortex - gamecube,2,0,1,1,5,9,3.7777777777777777
sacra terra: kiss of death [download],0,0,1,3,5,9,4.444444444444445
scooby-doo unmasked - playstation 2,0,0,0,2,7,9,4.777777777777778
gamecube controller (indigo / clear),0,1,0,1,7,9,4.555555555555555
final fantasy xiv: heavensward - playstation 4,0,0,1,0,8,9,4.777777777777778
resident evil essentials (resident evil code: veronica x / resident evil outbreak / resident evil 4),0,0,1,2,6,9,4.555555555555555
the biggest loser challenge - nintendo wii,0,0,2,1,6,9,4.444444444444445
retro-bit super retro advance adapter gba to snes - super nes,0,0,0,0,9,9,5.0
sid meier's civilization: beyond earth - pc,0,2,2,1,4,9,3.7777777777777777
thrustmaster t80 racing wheel ps4/pc,2,1,1,2,3,9,3.3333333333333335
darkstalkers chronicle: the chaos tower,0,1,1,1,6,9,4.333333333333333
fullmetal alchemist: dual sympathy - nintendo ds,2,1,1,3,2,9,3.2222222222222223
indiana jones and the emperor's tomb - pc,0,1,2,3,3,9,3.888888888888889
playstation 4 black friday bundle - lego batman 3 and little big planet 3[discontinued],1,0,1,0,7,9,4.333333333333333
nintendo ds game card case 6 - pink,0,0,1,6,2,9,4.111111111111111
vexx ngc,0,1,2,1,5,9,4.111111111111111
dark fall: the journal - pc,0,1,0,3,5,9,4.333333333333333
silicone protective case for controller (black),0,0,3,0,6,9,4.333333333333333
mystery p.i: the curious case of counterfeit cove,1,0,1,2,5,9,4.111111111111111
gunblade ny: special air assault force and l.a machineguns: rage of the machines - arcade hits pack - nintendo wii (special),0,1,0,2,6,9,4.444444444444445
club penguin: game day!,0,0,2,1,6,9,4.444444444444445
fight night round 2 - playstation 2,0,0,1,5,3,9,4.222222222222222
guitar hero van halen - playstation 3 (game only),0,1,3,1,4,9,3.888888888888889
the magical quest starring mickey mouse,0,0,2,1,6,9,4.444444444444445
xploder ps3 ultimate cheats system,3,4,0,2,0,9,2.111111111111111
prince of persia: sands of time - pc,0,1,1,4,3,9,4.0
simpsons road rage platinum hits - xbox,0,3,0,3,3,9,3.6666666666666665
lost: via domus - playstation 3,2,4,0,0,3,9,2.7777777777777777
disney infinity 3.0 edition: mulan figure - not machine specific,0,0,0,0,9,9,5.0
ys seven - sony psp,0,0,0,3,6,9,4.666666666666667
up - playstation 3,0,0,3,1,5,9,4.222222222222222
minecraft: story mode- the complete adventure - wii u,0,1,0,1,7,9,4.555555555555555
hori ps vita silicone protector,0,1,0,3,5,9,4.333333333333333
hyperkin retron 3 video game system for nes/snes/genesis,1,1,2,1,4,9,3.6666666666666665
gradius iii and iv -  playstation 2,1,1,0,0,7,9,4.222222222222222
logitech ps3 / ps2 wireless guitar controller,0,1,0,3,5,9,4.333333333333333
nintendo 3ds hard pouch - black,0,0,1,2,6,9,4.555555555555555
secret weapons over normandy,1,0,0,3,5,9,4.222222222222222
genma onimusha,0,0,2,4,3,9,4.111111111111111
"lego dimensions, exclusive ninjago jay fun pack (71215)",0,0,0,0,9,9,5.0
oculus touch,0,1,0,0,8,9,4.666666666666667
summoner 2,0,1,3,0,5,9,4.0
toejam & earl iii: mission to earth,1,1,0,1,6,9,4.111111111111111
virtua tennis 3 - playstation 3,0,0,2,4,3,9,4.111111111111111
the book of unwritten tales 2 - pc (uk import),1,0,2,1,5,9,4.0
disney infinity 3.0 edition: star wars rebels sabine wren figure,0,0,0,0,9,9,5.0
wipeout xl,0,1,0,2,6,9,4.444444444444445
sims 2 - nintendo ds,1,0,2,1,5,9,4.0
tekken 7 - xbox one,2,1,1,0,5,9,3.5555555555555554
sega 3d classics collection - nintendo 3ds,0,0,0,2,7,9,4.777777777777778
mischief makers,1,0,0,1,7,9,4.444444444444445
rock band 3 pro-cymbals expansion kit,1,1,0,0,7,9,4.222222222222222
turok: rage wars,0,0,0,3,6,9,4.666666666666667
"dreamgear universal nintendo 3ds, dsi xl, dsi, ds lite, and ds stylus pack and game case",0,0,2,0,7,9,4.555555555555555
"dreamgear ps3 elite gaming headset with inline chat and game volume controls and flexible, echo free boom mic",1,1,2,1,4,9,3.6666666666666665
band hero featuring taylor swift - stand alone software - nintendo wii,0,1,2,3,3,9,3.888888888888889
the darkness ii [download],0,1,2,1,5,9,4.111111111111111
power stone,1,0,1,2,5,9,4.111111111111111
tekken 6 - sony psp,0,0,1,1,7,9,4.666666666666667
"hitman trilogy (includes silent assassins, blood money and contracts) - pc",0,0,2,1,6,9,4.444444444444445
il-2 sturmovik - pc,1,1,1,1,5,9,3.888888888888889
gameband for minecraft - large,0,0,2,2,5,9,4.333333333333333
ridge racer - playstation vita,2,0,3,2,2,9,3.2222222222222223
toy soldiers: war chest hall of fame edition - xbox one standard edition,0,0,1,4,4,9,4.333333333333333
disney infinity 3.0 edition: star wars rebels zeb orrelios figure,0,0,0,0,9,9,5.0
life force - nintendo nes,0,0,0,3,6,9,4.666666666666667
skylanders superchargers starter pack - wii u,1,0,2,1,5,9,4.0
splashdown:  rides gone wild - playstation 2,0,0,1,3,5,9,4.444444444444445
the pinball of the dead,0,0,1,4,4,9,4.333333333333333
wwf wrestlemania 2000,0,0,1,1,7,9,4.666666666666667
band hero featuring taylor swift - stand alone software - playstation 3,0,1,1,1,6,9,4.333333333333333
dotop xbox controller for microsoft xbox black,1,0,0,1,7,9,4.444444444444445
dragon ball xenoverse - playstation 4,1,0,1,1,6,9,4.222222222222222
super swing golf - nintendo wii,1,1,2,4,1,9,3.3333333333333335
new carnival games - nintendo wii,1,1,1,3,3,9,3.6666666666666665
official 16 game clear case- pink - nintendo ds,1,0,0,3,5,9,4.222222222222222
dsi xl jumbo touch pen set - black/white/wine red,1,0,3,0,5,9,3.888888888888889
game & watch gallery 4,0,1,2,2,4,9,4.0
the club - xbox 360,0,1,2,3,3,9,3.888888888888889
guitar hero 5 - nintendo wii (game only),0,1,2,1,5,9,4.111111111111111
contract j.a.c.k. - pc,1,3,1,2,2,9,3.111111111111111
18 wheels of steel : american long haul - pc,0,0,4,2,3,9,3.888888888888889
opoona - nintendo wii,0,2,1,6,0,9,3.4444444444444446
knights contract - xbox 360,0,3,1,1,4,9,3.6666666666666665
wall-e,2,0,0,0,7,9,4.111111111111111
zero time dilemma  3ds,0,0,1,2,6,9,4.555555555555555
rayman advance,1,0,0,1,7,9,4.444444444444445
aliens versus predator - pc,0,0,1,4,4,9,4.333333333333333
mini ninjas - xbox 360,0,0,0,1,8,9,4.888888888888889
tom clancy's ghost recon:  advanced warfighter - playstation 2,2,0,1,3,3,9,3.5555555555555554
brothers in arms earned in blood - xbox,0,2,1,0,6,9,4.111111111111111
derblue black replacement trigger ps vita hand grip holder cover case for ps vita 2000,0,0,0,3,6,9,4.666666666666667
xbox one 1tb console : rise of the tomb raider bundle,4,0,0,2,3,9,3.0
predator concrete jungle - playstation 2,1,1,0,3,4,9,3.888888888888889
grand theft auto iv: the lost and damned - xbox 360,0,0,1,2,6,9,4.555555555555555
wheelman - playstation 3,0,1,2,1,5,9,4.111111111111111
fallout 4 - pip-boy edition - xbox one,1,0,1,3,4,9,4.0
simcity ds,0,1,1,6,1,9,3.7777777777777777
ecco the dolphin: defender of the future,1,0,0,5,3,9,4.0
skylanders swap force jolly bumble blast character,0,0,0,0,9,9,5.0
turtle beach - ear force x12 amplified stereo gaming headset - xbox 360 (discontinued by manufacturer),1,2,0,1,5,9,3.7777777777777777
final fantasy xiv: a realm reborn 60 day time card,0,0,0,0,9,9,5.0
rayman 2: the great escape,1,0,2,1,5,9,4.0
the incredible hulk - xbox 360,1,3,0,3,2,9,3.2222222222222223
iron man - nintendo ds,0,0,5,4,0,9,3.4444444444444446
conflict desert storm - xbox,0,1,2,2,4,9,4.0
transformers the game - playstation 3,0,1,0,0,8,9,4.666666666666667
the cursed crusade - xbox 360,1,0,3,1,4,9,3.7777777777777777
enemy territory: quake wars - xbox 360,0,1,2,2,4,9,4.0
transformers the game - sony psp,1,1,0,1,6,9,4.111111111111111
final fantasy type-0 hd collector's edition - playstation 4,1,0,0,1,7,9,4.444444444444445
r-type final,0,0,1,2,6,9,4.555555555555555
two worlds - pc,3,2,0,2,2,9,2.7777777777777777
the elder scrolls iii: morrowind,0,0,1,2,6,9,4.555555555555555
guitar hero 2 guitar controller,1,1,2,0,5,9,3.7777777777777777
assassin's creed iv black flag [online game code],1,0,1,3,4,9,4.0
sim theme park - pc,2,1,3,0,3,9,3.111111111111111
super collapse 3 nds,0,0,2,2,5,9,4.333333333333333
ninjatown - nintendo ds,0,0,0,2,7,9,4.777777777777778
payday 2 crimewave - xbox one,2,1,3,1,2,9,3.0
final fantasy viii [online game code],1,0,0,1,7,9,4.444444444444445
enclave,0,1,0,4,4,9,4.222222222222222
world series baseball 2k1,4,4,0,1,0,9,1.7777777777777777
spyro a hero's tail - playstation 2,1,0,2,4,2,9,3.6666666666666665
dragon ball z: super sonic warriors,0,0,0,1,8,9,4.888888888888889
escape the emerald star - pc/mac,0,0,0,1,8,9,4.888888888888889
hyperdimension neptunia re;birth1 - playstation vita,0,0,0,3,6,9,4.666666666666667
arc the lad twilight of the spirits - playstation 2,0,0,3,2,4,9,4.111111111111111
castlevania: nes classics,0,0,0,4,5,9,4.555555555555555
skate - xbox 360,0,0,2,1,6,9,4.444444444444445
samurai warriors - playstation 2,0,1,0,1,7,9,4.555555555555555
star wars: republic commando,0,0,1,3,5,9,4.444444444444445
madden nfl 08 - playstation 2,1,1,2,1,4,9,3.6666666666666665
rune factory: tides of destiny - playstation 3,0,0,0,4,5,9,4.555555555555555
beavis and butt-head,1,0,0,1,7,9,4.444444444444445
capcom fighting evolution,2,0,6,0,1,9,2.7777777777777777
rune factory: tides of destiny - nintendo wii,0,0,0,3,6,9,4.666666666666667
world in conflict: complete edition(european version),0,1,0,1,7,9,4.555555555555555
turtle beach - ear force x32 wireless gaming headset - amplified stereo - xbox 360 (discontinued by manufacturer),1,2,0,1,5,9,3.7777777777777777
fit in six - playstation 3,1,0,0,3,5,9,4.222222222222222
superman: shadow of apokolips,0,0,3,2,4,9,4.111111111111111
"turtle beach - ear force p12 - amplified stereo gaming headset - ps4, ps vita, and mobile devices - ffp",1,0,1,1,6,9,4.222222222222222
harry potter and the order of the phoenix - nintendo wii,0,1,0,4,4,9,4.222222222222222
atari anthology - playstation 2,0,0,2,2,5,9,4.333333333333333
target terror - nintendo wii,1,2,4,0,2,9,3.0
bloodrayne,1,0,3,0,5,9,3.888888888888889
nba 2k16 - michael jordan special edition - xbox one,0,0,1,3,5,9,4.444444444444445
tom clancy's rainbow six 3 - playstation 2,0,1,4,4,0,9,3.3333333333333335
pokemon battle revolution,1,0,3,2,3,9,3.6666666666666665
midnight mysteries: devil on the mississippi [download],1,0,4,2,2,9,3.4444444444444446
ps3 racing wheel controller,2,1,0,2,4,9,3.5555555555555554
fallout 3 game of the year [online game code],0,0,0,2,7,9,4.777777777777778
donkey kong country,0,0,1,0,8,9,4.777777777777778
xbox 360 slim / xbox 360 e and kinect carrying case,0,0,0,0,9,9,5.0
picross ds,0,0,0,4,5,9,4.555555555555555
star wars episode i: jedi power battles,1,2,0,1,5,9,3.7777777777777777
"usb microphone for rockband or guitar hero (ps3, wii, xbox360)",1,0,0,1,7,9,4.444444444444445
grand theft auto double pack: liberty city stories / vice city stories - playstation 2,0,0,1,2,6,9,4.555555555555555
ncaa football 10 - xbox 360,0,1,1,3,4,9,4.111111111111111
marvel vs. capcom: clash of super heroes,1,1,1,1,5,9,3.888888888888889
"the sims 3: barnacle bay [download code only, no disc included] - pc/mac",0,1,1,2,5,9,4.222222222222222
nascar the game 2011 - playstation 3,0,2,1,4,2,9,3.6666666666666665
ping pals - nintendo ds,5,2,1,0,1,9,1.8888888888888888
nascar '14 - playstation 3,0,0,1,3,5,9,4.444444444444445
inversion - xbox 360,0,4,2,3,0,9,2.888888888888889
mortal kombat: deadly alliance,0,1,0,3,5,9,4.333333333333333
unreal gold - pc,0,0,0,2,7,9,4.777777777777778
"mad catz c.t.r.l.r mobile gamepad and game controller for android, fire tv, samsung, pc, steam and gear vr - white",0,1,4,4,0,9,3.3333333333333335
mosuch usb charger cable for nintendo wii u gamepad controller,1,0,0,1,7,9,4.444444444444445
mysims - nintendo wii,1,0,2,3,3,9,3.7777777777777777
onimusha: blade warriors,0,0,0,2,7,9,4.777777777777778
robot amiibo - japan import (super smash bros series),0,0,0,1,8,9,4.888888888888889
game boy advance sp classic nes,0,0,1,0,8,9,4.777777777777778
fifa 15 (ultimate edition) - playstation 4,0,0,2,1,6,9,4.444444444444445
assassin's creed unity collector's edition - playstation 4,2,1,0,1,5,9,3.6666666666666665
mewtwo amiibo - japan import (super smash bros series),0,0,0,0,9,9,5.0
teenage mutant ninja turtles 2 battle nexus - playstation 2,0,1,1,0,7,9,4.444444444444445
thor: god of thunder - xbox 360,4,1,0,2,2,9,2.6666666666666665
carnival games: monkey see monkey do - xbox 360,0,0,2,3,4,9,4.222222222222222
disney infinity 3.0 edition: judy hopps figure,0,1,1,0,7,9,4.444444444444445
bust-a-move universe - nintendo 3ds,1,0,2,3,3,9,3.7777777777777777
gamesir g3s bluetooth wireless controller for android smartphone tablet vr pc tv box - ps3,1,1,1,1,5,9,3.888888888888889
evolve - pc,2,2,1,2,2,9,3.0
top spin 3 - xbox 360,4,0,0,3,2,9,2.888888888888889
nintendo new 3ds - pokemon 20th anniversary edition [discontinued],1,0,0,0,8,9,4.555555555555555
just dance 2015 - xbox one,0,0,1,2,6,9,4.555555555555555
red ninja end of honor - playstation 2,1,2,0,1,5,9,3.7777777777777777
punch out - nintendo nes,0,0,3,2,4,9,4.111111111111111
the sims 3: generations [online game code],1,0,1,3,4,9,4.0
speed racer: the videogame - nintendo ds,0,0,0,2,7,9,4.777777777777778
intellivision lives - playstation 2,0,3,3,2,1,9,3.111111111111111
xbox 360 resident evil 5 elite red console,0,0,0,2,7,9,4.777777777777778
toy shop - nintendo ds,9,0,0,0,0,9,1.0
fire emblem fates: map pack 1 dlc - 3ds [digital code],0,0,1,3,5,9,4.444444444444445
atelier shallie: alchemists of the dusk sea - playstation 3,1,1,2,0,5,9,3.7777777777777777
battlestations midway - xbox 360,0,0,2,1,6,9,4.444444444444445
fantastic 4: rise of the silver surfer - playstation 2,0,1,3,2,3,9,3.7777777777777777
sony playstation portable 2001,0,0,0,4,5,9,4.555555555555555
ps3 bluetooth headset - urban camo,1,2,1,0,5,9,3.6666666666666665
tomb raider: the last revelation - pc,2,2,0,2,3,9,3.2222222222222223
lego indiana jones: the original adventures,2,0,0,4,3,9,3.6666666666666665
dawn of mana - playstation 2,1,3,1,1,3,9,3.2222222222222223
the legend of zelda: four swords adventures,0,0,2,3,4,9,4.222222222222222
littlebigplanet 2 special edition move bundle - playstation 3,0,0,1,0,8,9,4.777777777777778
monster hunter cross hunting gear for new nintendo 3ds ll,0,1,0,0,8,9,4.666666666666667
"pdp sony afterglow lvl 3 stereo gaming headset 051-032, black",1,0,0,6,2,9,3.888888888888889
22-in-1 deluxe starter kit - blue/white for dsi,0,1,0,2,6,9,4.444444444444445
need for speed: hot pursuit 2 - pc,2,0,2,2,3,9,3.4444444444444446
the punisher - xbox,0,0,0,5,4,9,4.444444444444445
full spectrum warrior - xbox,0,1,2,4,2,9,3.7777777777777777
sonic 3d blast,1,1,1,0,6,9,4.0
mlb 08 the show - sony psp,0,0,0,2,7,9,4.777777777777778
mmr umd psp replacement game case 10 pack clear,0,0,0,3,6,9,4.666666666666667
mickey mousecapade,0,4,0,1,4,9,3.5555555555555554
ridge racer v - playstation 2,2,2,2,1,2,9,2.888888888888889
the simpson's wrestling,2,1,1,3,2,9,3.2222222222222223
suikoden tactics - playstation 2,0,1,3,0,5,9,4.0
namco museum battle collection - sony psp,1,0,0,3,5,9,4.222222222222222
disney infinity 3.0: the force awakens bundle - amazon exclusive,0,0,1,1,7,9,4.666666666666667
pac-man world,0,0,0,3,6,9,4.666666666666667
return to castle wolfenstein (game of the year edition),0,0,1,2,6,9,4.555555555555555
dark souls iii: collectors edition - playstation 4,0,0,0,1,8,9,4.888888888888889
harry potter and the chamber of secrets - pc,1,1,0,2,5,9,4.0
sonic heroes - xbox,2,1,2,1,3,9,3.2222222222222223
mario golf,0,0,0,2,7,9,4.777777777777778
donkey kong country 3,0,0,1,2,6,9,4.555555555555555
ultimate mortal kombat 3,0,2,1,0,6,9,4.111111111111111
yu-gi-oh! duelists of the roses,1,0,0,4,4,9,4.111111111111111
tom clancy's splinter cell: pandora tomorrow - playstation 2,0,0,2,4,3,9,4.111111111111111
trackmania turbo - playstation 4,1,0,1,1,6,9,4.222222222222222
growlanser:  generations - playstation 2,0,1,0,2,6,9,4.444444444444445
pokemon green (pocket monsters midori) japanese game boy japan import,0,0,0,1,8,9,4.888888888888889
gioteck ex03  bluetooth headset for ps3,1,2,1,3,2,9,3.3333333333333335
nintendo nes zapper light gun,0,0,0,2,7,9,4.777777777777778
batman vengeance,2,1,0,2,4,9,3.5555555555555554
teenage mutant ninja turtles,0,0,4,2,3,9,3.888888888888889
the simpsons: hit and run,1,0,3,1,4,9,3.7777777777777777
leegoal wired infrared sensor bar for nintendo wii,0,0,2,2,5,9,4.333333333333333
madden nfl 16 - playstation 3,1,1,0,0,7,9,4.222222222222222
bruce lee: quest of the dragon,3,1,2,1,2,9,2.7777777777777777
nike toddlers tanjun (tdv) running shoe,1,0,1,2,5,9,4.111111111111111
run like hell,1,0,1,2,5,9,4.111111111111111
ea sports 2014 fifa world cup brazil - playstation 3,1,2,0,1,5,9,3.7777777777777777
sniper elite ( windows ),3,0,1,4,1,9,3.0
rpg maker 3 - playstation 2,1,2,2,2,2,9,3.2222222222222223
sacred 3 - xbox 360,2,0,1,3,3,9,3.5555555555555554
atv offroad fury ps2,1,0,1,2,5,9,4.111111111111111
super adventure island,2,0,1,1,5,9,3.7777777777777777
replacement joystick,0,0,3,1,5,9,4.222222222222222
castlevania 64,0,1,0,3,5,9,4.333333333333333
"age of empires ii, gold edition - pc",1,0,1,1,6,9,4.222222222222222
imp tech trigger treadz (xbox one),0,2,0,4,3,9,3.888888888888889
"lowpricenice xbox 360 controller battery cover, white",0,1,1,1,6,9,4.333333333333333
metal gear solid 4: guns of the patriots limited edition,0,0,0,0,9,9,5.0
simpsons: hit and run - xbox,0,1,2,3,3,9,3.888888888888889
"sniper elite v2, silver star edition",0,0,0,2,7,9,4.777777777777778
nintendo gamecube game boy advance cable - game console link cable,0,0,0,2,7,9,4.777777777777778
watchmen: the end is nigh the complete experience,0,0,1,4,4,9,4.333333333333333
the beatles: rock band (game only) - nintendo wii,0,0,2,2,5,9,4.333333333333333
tom clancy's ghost recon wildlands (gold edition) - xbox one,0,1,1,0,7,9,4.444444444444445
penumbra collection - pc,0,0,1,4,4,9,4.333333333333333
enemy territory: quake wars - pc,1,1,1,2,4,9,3.7777777777777777
operation flashpoint: dragon rising - pc,0,1,3,1,4,9,3.888888888888889
teenage mutant ninja turtles: smash-up - playstation 2,0,1,2,2,4,9,4.0
resident evil 3: nemesis - sega dreamcast,0,0,0,5,4,9,4.444444444444445
call of duty: advanced warfare (gold edition) - playstation 4,1,2,0,1,5,9,3.7777777777777777
yo-kai watch 2: fleshy souls - nintendo 3ds,0,1,0,0,8,9,4.666666666666667
table tennis - xbox 360,0,1,2,4,2,9,3.7777777777777777
"ds mini backpack case for nintendo dsi and nintendo ds lite, dark blue",0,0,1,4,4,9,4.333333333333333
the lord of the rings: the battle for middle-earth ii - xbox 360,0,0,1,4,4,9,4.333333333333333
the bureau: xcom declassified - playstation 3,1,1,0,3,4,9,3.888888888888889
assetto corsa - playstation 4 standard edition,3,0,1,1,4,9,3.3333333333333335
superman returns - playstation 2,2,3,1,1,2,9,2.7777777777777777
genji: dawn of the samurai,0,0,0,3,6,9,4.666666666666667
skylanders giants: single character pack core series 2 whirl wind,0,0,1,0,8,9,4.777777777777778
driver: san francisco - pc,2,1,2,1,3,9,3.2222222222222223
skylanders giants: single character pack core series 2 double trouble,0,0,0,0,9,9,5.0
resistance: fall of man - playstation 3,0,0,3,0,6,9,4.333333333333333
psp ac adaptor,0,1,1,1,6,9,4.333333333333333
tony hawk's pro skater 3,0,0,2,4,3,9,4.111111111111111
harry potter and the half blood prince - nintendo wii,1,0,0,2,6,9,4.333333333333333
tom clancy's splinter cell blacklist - pc,0,0,2,2,5,9,4.333333333333333
the sims 4 cool kitchen stuff [online game code],1,0,1,2,5,9,4.111111111111111
the walking dead: 400 days [online game code],2,2,2,1,2,9,2.888888888888889
final fantasy vii [online game code],0,0,0,3,6,9,4.666666666666667
call of juarez - pc,0,1,1,4,3,9,4.0
sid meier's railroads! - pc,1,4,1,2,1,9,2.7777777777777777
halo 5 guardians - xbox one digital code,2,0,2,1,4,9,3.5555555555555554
nba live 09 - playstation 3,0,0,2,0,7,9,4.555555555555555
bioshock infinite: the complete edition - xbox 360,0,0,0,2,7,9,4.777777777777778
jeopardy - playstation 2,1,0,2,2,4,9,3.888888888888889
playstation portable limited edition star wars battlefront renegade squadron entertainment pack - ceramic white,0,0,0,3,6,9,4.666666666666667
wildstar [online game code],1,0,2,3,3,9,3.7777777777777777
house of the dead iii,0,0,1,2,6,9,4.555555555555555
zumba fitness world party - xbox one,0,0,1,0,8,9,4.777777777777778
call of cthulhu: dark corners of the earth,0,1,1,3,4,9,4.111111111111111
halo wars 2 - xbox one,0,1,1,3,4,9,4.111111111111111
tomba!,0,0,0,3,6,9,4.666666666666667
tom clancy's rainbow six siege (beta) - [uplay code],1,1,0,2,5,9,4.0
extremerate light bar decal stickers set of 30 different pcs for ps4 playstation 4 ps4 ps4 slim ps4 pro controller - color prints game theme mix stickers ?new,0,0,0,1,8,9,4.888888888888889
xbox one special edition midnight forces wireless controller,1,0,0,1,7,9,4.444444444444445
mortal kombat komplete edition [download],0,0,2,3,4,9,4.222222222222222
saints row: gat out of hell,2,0,2,1,4,9,3.5555555555555554
the king of fighters xiv: steelbook launch edition - playstation 4,1,0,0,1,7,9,4.444444444444445
exist archive: the other side of the sky - playstation vita,1,1,2,2,3,9,3.5555555555555554
exist archive: the other side of the sky - playstation 4,0,1,2,1,5,9,4.111111111111111
jewel quest mysteries - nintendo ds,1,0,2,2,4,9,3.888888888888889
age of empires iii: the asian dynasties expansion pack,0,1,3,1,4,9,3.888888888888889
30 day membership: runescape 3 [instant access],1,1,0,2,5,9,4.0
need for speed: undercover - playstation 2,1,1,0,1,6,9,4.111111111111111
turtle beach call of duty advanced warfare ear force sentinel task force gaming headset for playstation 4,0,0,1,1,7,9,4.666666666666667
dragon ball z: battle of z - xbox 360,1,1,1,0,6,9,4.0
guild wars 2 [download],1,2,2,0,4,9,3.4444444444444446
titan quest - pc,0,1,0,0,8,9,4.666666666666667
"pack of 16pcs pandaren thumb grip thumbstick noctilucent sets for ps2, ps3, ps4, xbox 360, xbox one controller",1,0,0,4,4,9,4.111111111111111
lost kingdoms,0,1,0,4,4,9,4.222222222222222
chibi-robo,0,0,0,1,8,9,4.888888888888889
dark souls ii: scholar of the first sin - playstation 3,0,0,1,2,6,9,4.555555555555555
saints row the third - the full package [download],0,0,2,3,4,9,4.222222222222222
line of sight: vietnam - pc,2,1,3,1,2,9,3.0
grand slam tennis,0,1,1,3,4,9,4.111111111111111
nba 2k10 - playstation 3,0,1,1,3,4,9,4.111111111111111
clock tower,0,0,2,2,5,9,4.333333333333333
nintendo virtual boy - video game console,6,0,0,1,2,9,2.2222222222222223
neverwinter nights 2: storm of zehir expansion - pc,0,2,4,1,2,9,3.3333333333333335
company of heroes: tales of valor - pc,2,2,1,1,3,9,3.111111111111111
driver parallel lines - playstation 2,0,0,0,1,8,9,4.888888888888889
astro gaming a40 headset + mixamp m80 - dark grey/orange - xbox one (2014 model),1,1,2,1,4,9,3.6666666666666665
the order: 1886 - ps4 [digital code],1,0,2,5,1,9,3.5555555555555554
armored core: for answer - playstation 3,0,1,3,3,2,9,3.6666666666666665
wanted: weapons of fate - pc,0,2,1,4,2,9,3.6666666666666665
splinter cell double agent - playstation 2,0,0,0,3,6,9,4.666666666666667
nintendo mario kart 8 deluxe set with dlc wii u bundle,1,0,0,3,5,9,4.222222222222222
trials fusion,2,0,1,2,4,9,3.6666666666666665
thief gold [download],2,0,0,1,6,9,4.0
the sims 3 dragon valley - pc/mac,1,1,3,0,4,9,3.5555555555555554
elex - playstation 4,0,1,0,3,5,9,4.333333333333333
reality fighters - playstation vita,0,0,2,2,5,9,4.333333333333333
mafia - xbox,0,1,1,3,4,9,4.111111111111111
playstation 3 rock band wireless guitar,0,1,1,4,3,9,4.0
nintendo mii brawler amiibo (super smash bros. series) for wii u,0,0,0,1,8,9,4.888888888888889
"nba street, vol. 2 (platinum hits) - xbox",0,0,0,4,5,9,4.555555555555555
dreamgear ps3 quad charging dock charges up to four ps3 controllers simultaneously.  leds help monitor charge status,0,0,0,2,7,9,4.777777777777778
virtua tennis 4 - world tour edition,0,1,0,2,6,9,4.444444444444445
final fantasy xiv: a realm reborn collector's edition [download],1,0,1,1,6,9,4.222222222222222
the godfather ii - pc,2,0,0,3,4,9,3.7777777777777777
lord of magna: maiden heaven - nintendo 3ds,0,0,0,4,5,9,4.555555555555555
michael jackson's moonwalker - sega genesis,1,1,0,0,7,9,4.222222222222222
playstation 2 8mb memory card (yellow),1,0,2,0,6,9,4.111111111111111
mega man powered up - sony psp,0,0,0,2,7,9,4.777777777777778
jurassic park,1,0,0,2,6,9,4.333333333333333
harvest moon ds,0,3,0,2,4,9,3.7777777777777777
neverwinter nights: hordes of the underdark expansion pack - pc,0,0,1,1,7,9,4.666666666666667
jurassic: the hunted - xbox 360,0,0,4,5,0,9,3.5555555555555554
lego batman 3: beyond gotham + the sly collection playstation 3 500gb bundle,0,0,0,0,9,9,5.0
call of duty: advanced warfare (gold edition) - playstation 3,0,0,0,2,7,9,4.777777777777778
"skylanders spyro's adventure triple character pack (wrecking ball, stealth elf, sonic boom)",0,0,0,2,7,9,4.777777777777778
nintendo wii remote plus - pink,0,0,0,2,7,9,4.777777777777778
looney tunes: acme arsenal - playstation 2,0,0,1,1,7,9,4.666666666666667
final fantasy xiv online,3,1,0,0,5,9,3.3333333333333335
special designed bluetooth bt headset for sony playstation 3 ps3 game and gaming(black),0,0,1,1,7,9,4.666666666666667
the king of fighters xiv - playstation 4,1,0,2,1,5,9,4.0
ddr: dance dance revolution konamix (greatest hits) ps,0,0,0,3,6,9,4.666666666666667
logitech wireless microphone - playstation 3,0,0,0,4,5,9,4.555555555555555
cars,0,0,2,1,6,9,4.444444444444445
cars - gamecube,0,0,1,2,6,9,4.555555555555555
rise of nations: rise of legends - pc,0,3,3,2,1,9,3.111111111111111
pac-man and the ghostly adventures - xbox 360,0,1,2,1,5,9,4.111111111111111
daxter and secret agent clank psp umd dual pack,0,0,2,2,5,9,4.333333333333333
wwe 2k17 - xbox one,2,0,2,2,3,9,3.4444444444444446
phineas and ferb - nintendo ds,0,0,0,1,8,9,4.888888888888889
nba 2k8 - xbox 360,0,0,2,4,3,9,4.111111111111111
dragon ball z : attack of the saiyans - nintendo ds,1,0,0,2,6,9,4.333333333333333
xbox one kinect sensor,1,1,0,0,7,9,4.222222222222222
scratches - pc,0,0,4,4,1,9,3.6666666666666665
blazblue: chrono phantasma extend - playstation 4,0,0,0,2,7,9,4.777777777777778
wonderbook: book of spells,0,2,1,1,5,9,4.0
bomberman generation,0,0,1,5,3,9,4.222222222222222
moon - nintendo ds,0,2,3,2,2,9,3.4444444444444446
tomb raider iii: adventures of lara croft,2,0,2,2,3,9,3.4444444444444446
pdp titanfall 2 official marauder srs stereo headset for xbox one,0,1,2,3,3,9,3.888888888888889
ju-on: the grudge - nintendo wii,2,3,1,0,3,9,2.888888888888889
"sakura wars: so long, my love",1,0,0,1,7,9,4.444444444444445
p.n.03 (product number 03) - gamecube,1,0,2,2,4,9,3.888888888888889
50 classic games ds,0,0,2,1,6,9,4.444444444444445
lost dimension - playstation vita,0,0,0,2,7,9,4.777777777777778
ultimate combo pack: god of war saga & red dualshock3 wireless controller - playstation 3,0,0,0,2,7,9,4.777777777777778
nba live 2005,0,0,0,4,5,9,4.555555555555555
call of duty 4: modern warfare,0,1,0,4,4,9,4.222222222222222
x-men legends ii rise of the apocalypse - gamecube,0,0,2,5,2,9,4.0
call of duty: black ops iii - digital deluxe edition - playstation 4 [digital code],3,0,0,2,4,9,3.4444444444444446
unreal anthology - pc,0,0,1,1,7,9,4.666666666666667
xbox $50 gift card,0,1,0,0,8,9,4.666666666666667
legend of spyro: dawn of the dragon - playstation 3,0,0,1,3,5,9,4.444444444444445
trinity: souls of zill o'll - playstation 3,0,0,0,5,4,9,4.444444444444445
call of duty: ghosts hardened edition - playstation 3,0,1,2,2,4,9,4.0
five nights at freddy's demo [download],2,1,2,1,3,9,3.2222222222222223
medal of honor european assault - xbox,1,0,1,3,4,9,4.0
tiger woods pga tour 10 wii motion plus bundle,0,1,0,3,5,9,4.333333333333333
rad racer,0,2,1,1,5,9,4.0
nba 2k7 - xbox 360,0,1,2,4,2,9,3.7777777777777777
the lord of the rings the third age - xbox,0,0,2,5,2,9,4.0
ortz® analog thumb grip stick covers for ps4 / xbox 360 / xbox one / ps3 / ps2 - made of silicone rubber - best caps for gaming - remote skins for controller - blue & black set (2 pairs total),0,0,1,1,7,9,4.666666666666667
neogeo battle coliseum - playstation 2,0,0,1,4,4,9,4.333333333333333
nano breaker - playstation 2,2,0,2,1,4,9,3.5555555555555554
l.a. noire [download],1,1,1,3,3,9,3.6666666666666665
nintendo wii/wii u remote plus controller - bowser (japanese version),0,0,0,0,9,9,5.0
crimson skies - pc,0,0,0,6,3,9,4.333333333333333
ultimate board game collection - playstation 2,0,0,2,2,5,9,4.333333333333333
hard reset: extended edition - pc,1,0,2,1,5,9,4.0
brunswick pro bowling (requires kinect) - xbox 360,0,0,0,3,6,9,4.666666666666667
call of duty 3 - xbox,0,0,2,2,5,9,4.333333333333333
scrabble - nintendo ds,0,0,2,2,5,9,4.333333333333333
need for speed: prostreet - playstation 2,1,2,0,1,5,9,3.7777777777777777
super mario all-stars / super mario world,0,0,0,0,9,9,5.0
xbox 360 faceplate hotrod,0,0,1,3,5,9,4.444444444444445
fifa 15 - playstation vita,2,0,3,0,4,9,3.4444444444444446
infinite air - playstation 4,2,0,1,1,5,9,3.7777777777777777
medal of honor: heroes 2 - nintendo wii,1,0,3,4,1,9,3.4444444444444446
playstation 4 camera mount by foamy lizard ® sturdy ps4 camera tv mounting clip stand for playstation 4 console sensor,0,1,0,2,6,9,4.444444444444445
all star baseball 2003,0,2,1,4,2,9,3.6666666666666665
marvel nemesis: rise of the imperfects - gamecube,0,2,2,3,2,9,3.5555555555555554
mystery case files: the malgrave incident - nintendo wii,0,0,2,1,6,9,4.444444444444445
playground - nintendo wii,0,1,2,5,1,9,3.6666666666666665
nintendo 3ds xl new super mario bros 2 limited edition,0,0,0,0,9,9,5.0
prototype platinum hits -xbox 360,0,0,2,3,4,9,4.222222222222222
batman: arkham origins - collector's edition,0,0,0,1,8,9,4.888888888888889
polarium - nintendo ds,0,0,3,4,2,9,3.888888888888889
paperboy,1,0,2,1,5,9,4.0
time crisis ii,0,0,1,2,6,9,4.555555555555555
resident evil 6 - xbox one,0,0,1,3,5,9,4.444444444444445
way of the samurai 3 - playstation 3,2,1,1,0,5,9,3.5555555555555554
hori playstation 3 gem pad 3 - onyx black,0,1,1,3,4,9,4.111111111111111
hyperdimension neptunia u: action unleashed - playstation vita,0,0,1,4,4,9,4.333333333333333
donkey kong jungle beat - gamecube (game),0,0,0,2,7,9,4.777777777777778
breath of fire ii,0,0,1,2,6,9,4.555555555555555
rapala tournament fishing - nintendo wii,1,3,1,3,1,9,3.0
madden nfl 09 20th anniversary collectors edition -xbox 360,0,0,2,4,3,9,4.111111111111111
gam3gear snes nintendo n64 gamecube s video cable,1,0,0,1,7,9,4.444444444444445
xbox 360 les paul wireless guitar,2,2,0,0,5,9,3.4444444444444446
conflict:  desert storm ii - back to baghdad - playstation 2,0,1,0,4,4,9,4.222222222222222
"spore galactic adventures expansion pack - pc/mac, requires spore to play.",1,0,1,0,7,9,4.333333333333333
sonic unleashed - playstation 2,2,0,0,0,7,9,4.111111111111111
harvest moon: friends of mineral town,0,1,0,3,5,9,4.333333333333333
retro-bit retrogen adapter genesis to snes cartridge adapter,0,1,0,2,6,9,4.444444444444445
castlevania lords of shadow collection,0,0,0,1,8,9,4.888888888888889
tenchu: fatal shadows,1,0,0,0,8,9,4.555555555555555
homeworld - pc,0,1,1,1,6,9,4.333333333333333
technoskin - compact travel carrying case for new 3ds or new 3ds xl - black - 8 game holders - hard cover - mesh accessory pouch - carrying strap,0,0,0,2,7,9,4.777777777777778
demigod - pc,2,1,0,3,3,9,3.4444444444444446
crash tag team racing - playstation 2,1,1,0,2,5,9,4.0
mega man,0,1,2,2,4,9,4.0
smuggler's run - playstation 2,0,0,3,2,4,9,4.111111111111111
the sims livin' large expansion pack - pc,0,0,1,2,6,9,4.555555555555555
fullmetal alchemist 2: curse of the crimson elixir - playstation 2,0,0,0,5,4,9,4.444444444444445
pariah - pc,1,1,5,1,1,9,3.0
dark void - pc,1,2,4,2,0,9,2.7777777777777777
extremerate 30 pcs/set vinyl reuseable lighttight led light bar decals stickers for playstation 4 ps4 ps4 slim ps4 pro remote controller skins (k),0,0,0,1,8,9,4.888888888888889
star wars jedi knight ii: jedi outcast,0,0,1,4,4,9,4.333333333333333
ps2 dualshock 2 controller - satin silver,1,0,2,1,5,9,4.0
afterglow ax.1 controller for xbox 360 - red,0,1,1,0,7,9,4.444444444444445
afterglow ap.1 controller for ps3 - blue,0,1,3,1,4,9,3.888888888888889
skylanders superchargers: drivers shark shooter terrafin character pack,0,0,0,0,9,9,5.0
call of duty: ghosts hardened edition - xbox 360,1,0,0,1,7,9,4.444444444444445
insten red black & light blue silicone skin case combo compatible with ps3 controller,0,1,1,1,6,9,4.333333333333333
top spin 2 - xbox 360,0,0,3,2,4,9,4.111111111111111
demon gaze - playstation vita,0,0,1,1,7,9,4.666666666666667
crash nitro kart - playstation 2,0,0,2,1,6,9,4.444444444444445
james bond 007 everything or nothing - xbox,2,0,0,3,4,9,3.7777777777777777
life is strange - playstation 4,0,1,1,1,6,9,4.333333333333333
blood bowl - xbox 360,1,2,4,2,0,9,2.7777777777777777
pro evolution soccer 2013 - xbox 360,0,0,1,2,6,9,4.555555555555555
nyko intercooler - cooling attachment with pass through power for playstation 4,0,2,4,1,2,9,3.3333333333333335
dead or alive 5 plus,1,0,0,3,5,9,4.222222222222222
james bond 007: from russia with love - xbox,0,0,0,2,7,9,4.777777777777778
counter-strike: condition zero - pc,0,3,0,2,4,9,3.7777777777777777
nhl 2002 ps2,0,0,2,2,5,9,4.333333333333333
the bureau: xcom declassified [download],0,2,2,3,2,9,3.5555555555555554
ps3 guitar hero world tour guitar kit,0,0,1,3,5,9,4.444444444444445
kontrol freek thumb stick addon alpha - black (ps4),2,0,2,0,5,9,3.6666666666666665
nba 2k17 - early tip off edition - playstation 4,1,2,0,1,5,9,3.7777777777777777
gamecube controller platinum,0,0,2,2,5,9,4.333333333333333
the golf club: collector's edition - playstation 4,2,0,3,3,1,9,3.111111111111111
sony playstation ps3 dualshock 3 controller - blue (99007),0,0,1,0,8,9,4.777777777777778
game genie video game enhancer,0,0,0,2,7,9,4.777777777777778
let's draw!,0,1,1,2,5,9,4.222222222222222
forza motorsport 4 limited edition -xbox 360,0,0,0,1,8,9,4.888888888888889
7 days to die - xbox one,4,2,0,0,3,9,2.5555555555555554
marvel ultimate alliance - nintendo wii,0,1,0,2,6,9,4.444444444444445
minecraft: story mode - season disc - xbox one,1,0,1,1,6,9,4.222222222222222
prince of persia: warrior within - gamecube,0,0,0,5,4,9,4.444444444444445
puzzle quest 2 - nintendo ds,0,0,2,4,3,9,4.111111111111111
scooby doo! first frights nds,0,0,1,0,8,9,4.777777777777778
ace combat x: skies of deception - sony psp,1,0,0,3,5,9,4.222222222222222
guild wars: eye of the north expansion pack - pc,0,0,1,7,1,9,4.0
james bond 007: quantum of solace - nintendo wii,1,1,2,2,3,9,3.5555555555555554
"hori real arcade pro 4 kai for playstation 4, playstation 3, and pc",0,1,1,2,5,9,4.222222222222222
need for speed:  underground rivals - sony psp,1,1,3,0,4,9,3.5555555555555554
transformers rise of the dark spark - xbox one,1,0,2,1,4,8,3.875
1001 touch games - nintendo ds,0,0,1,2,5,8,4.5
lego harry potter: years 5 - 7 - nintendo ds,0,0,0,2,6,8,4.75
fallout 2 - pc,0,0,1,1,6,8,4.625
battalion wars 2 - nintendo wii,0,0,3,2,3,8,4.0
soul nomad & the world eaters,0,0,3,2,3,8,4.0
nano assault - nintendo 3ds,0,0,1,2,5,8,4.5
cruis'n - nintendo wii,0,1,4,3,0,8,3.25
transformers rise of the dark spark - xbox 360,1,0,1,0,6,8,4.25
tony hawk proving ground - playstation 3,0,2,0,3,3,8,3.875
art of fighting anthology - playstation 2,1,0,1,5,1,8,3.625
elder scrolls v: skyrim collector's edition - playstation 3,1,0,0,0,7,8,4.5
spartan: total warrior - playstation 2,0,1,0,5,2,8,4.0
transformers rise of the dark spark - playstation 3,1,0,0,2,5,8,4.25
gauntlet seven sorrows - playstation 2,0,0,1,2,5,8,4.5
dance dance revolution extreme - playstation 2,0,1,1,0,6,8,4.375
lego harry potter: years 5-7 - nintendo 3ds,0,0,1,3,4,8,4.375
battlefield 2 modern combat - playstation 2,0,0,1,2,5,8,4.5
fast & furious: showdown - playstation 3,1,0,0,1,6,8,4.375
toy story 2,0,0,1,3,4,8,4.375
asteroids,0,0,0,1,7,8,4.875
star wars racer revenge,0,1,1,4,2,8,3.875
singstar bundle - playstation 3,0,1,1,2,4,8,4.125
beowulf: the game - playstation 3,1,0,2,3,2,8,3.625
metro: last light limited edition - playstation 3,0,0,0,2,6,8,4.75
gears of war 3 controller - xbox 360 (special),0,0,0,1,7,8,4.875
nintendo 3ds xl - yellow pikachu,0,0,0,0,8,8,5.0
nhl 08 - playstation 3,0,1,0,3,4,8,4.25
guilty gear x2: the midnight carnival reload,0,0,1,3,4,8,4.375
chessmaster: grandmaster edition,0,2,1,1,4,8,3.875
mind zero - playstation vita,0,2,1,1,4,8,3.875
7 wonders 3: treasure of seven,0,0,0,1,7,8,4.875
jewel quest expedition - nintendo ds,0,1,2,2,3,8,3.875
universe at war: earth assault - pc,1,0,2,5,0,8,3.375
urbz: sims in the city - xbox,2,2,0,1,3,8,3.125
naruto: rise of a ninja - xbox 360,0,0,2,2,4,8,4.25
disney infinity 3.0 edition: pixar's the good dinosaur power disc pack,0,0,0,1,7,8,4.875
skylanders spyro's adventure: boomer,0,0,0,1,7,8,4.875
midway arcade treasures 2 - gamecube,0,0,1,2,5,8,4.5
minecraft: story mode - season disc - playstation 3,0,0,0,2,6,8,4.75
rogue warrior - xbox 360,2,2,0,2,2,8,3.0
tokobot - sony psp,0,0,1,4,3,8,4.25
pac-man,1,2,0,3,2,8,3.375
disney infinity 3.0 edition: star wars kanan jarrus light fx figure - amazon exclusive,0,0,0,2,6,8,4.75
tiger woods pga tour 2005 - playstation 2,0,0,0,6,2,8,4.25
ecco the dolphin: defender of the future,1,0,1,1,5,8,4.125
evolve ultimate edition - playstation 4,2,1,0,1,4,8,3.5
sid meier's civilization iv: gold edition - pc,1,0,1,3,3,8,3.875
the incredibles,1,1,1,2,3,8,3.625
deus ex: mankind divided - collector's edition - playstation 4,0,0,0,1,7,8,4.875
motortown: soul of the machine [download],0,0,2,1,5,8,4.375
alex hunter: lord of the mind [download],1,0,0,5,2,8,3.875
hori screen protective filter - nintendo 2ds,0,0,0,2,6,8,4.75
mass effect 3 collector's edition - playstation 3,0,1,0,0,7,8,4.625
"nintendo 3ds xl screen protector + full body (nintendo 3ds ll,2015), skinomi® techskin full coverage skin + screen protector for nintendo 3ds xl front & back clear hd film",1,1,2,1,3,8,3.5
cta digitalmulti-function carrying case for playstation 4 ps4-mfc,0,0,0,2,6,8,4.75
path of exile [download],3,1,2,1,1,8,2.5
call of duty: black ops iii – steelbook edition – xbox one  - amazon exclusive,0,0,2,2,4,8,4.25
skylanders spyro's adventure: eruptor,0,1,2,1,4,8,4.0
playboy: the mansion,1,2,1,3,1,8,3.125
skylanders spyro's adventure: zap,0,1,0,1,6,8,4.5
borderlands triple pack - playstation 3,0,0,0,1,7,8,4.875
f1 2011 - xbox 360,0,0,2,1,5,8,4.375
xbox 360 limited edition kinect star wars bundle,0,0,0,3,5,8,4.625
beowulf: the game,2,0,1,1,4,8,3.625
"xbox one console - white ""i made this"" edition (white *exclusive ""i made this"" edition*)",5,0,0,0,3,8,2.5
wii play motion (nintendo wii),0,0,1,2,5,8,4.5
the lake house: children of silence [download],0,0,3,2,3,8,4.0
overlord - pc,1,0,1,4,2,8,3.75
street fighter 2010: the final fight,0,0,1,4,3,8,4.25
need for speed & steelbook (amazon exclusive) - playstation 4,3,0,1,0,4,8,3.25
my french coach - nintendo ds,0,0,0,2,6,8,4.75
spiderman: friend or foe - playstation 2,0,1,2,1,4,8,4.0
midnight club 3: dub edition - xbox (dub),0,0,1,2,5,8,4.5
udraw game tablet with udraw studio: instant artist - playstation 3,2,0,2,0,4,8,3.5
birds of steel - playstation 3,0,1,2,2,3,8,3.875
genuine sega original saturn controller model # mk-80116,0,1,1,0,6,8,4.375
lost planet extreme condition,2,0,1,2,3,8,3.5
amazonbasics vertical stand for sony ps4 (officially licensed by sony),0,0,0,2,6,8,4.75
pirates: the legend of black kat,0,0,1,4,3,8,4.25
wwe wrestlemania x8,2,1,0,1,4,8,3.5
xbox cordless precision controller,0,0,1,1,6,8,4.625
star wars: battlefront - season pass - playstation 4 [digital code],3,0,3,1,1,8,2.625
naruto: clash of ninja revolution - nintendo wii,0,1,1,2,4,8,4.125
peter jackson's king kong: the official game of the movie - pc,1,1,2,2,2,8,3.375
mortal kombat shaolin monks - xbox,0,0,1,2,5,8,4.5
metal gear rising: revengeance [online game code],2,0,1,2,3,8,3.5
top gun,1,1,2,2,2,8,3.375
nintendo 3ds xl - pink/white,0,0,0,1,7,8,4.875
cabela's big game hunter 2012 with top shot elite - playstation 3,0,1,0,1,6,8,4.5
battleship/connect 4/sorry/trouble - nintendo ds,1,0,1,2,4,8,4.0
harry potter and the goblet of fire - gamecube,1,0,2,2,3,8,3.75
320gb hdd hard drive for xbox 360 slim - generic version,1,0,0,1,6,8,4.375
serious sam 3: bfe [download],0,0,1,4,3,8,4.25
mega man battle network,0,0,1,2,5,8,4.5
dynasty warriors 5 - playstation 2,0,0,2,3,3,8,4.125
"leegoal 360 controller custom mod kit - black - thumbsticks, dpad, rb lb, abxy, trim, guide, t8 security driver",1,0,1,1,5,8,4.125
rayman origins,0,1,1,1,5,8,4.25
spongebob squarepants: plankton's robotic revenge - playstation 3,1,1,0,1,5,8,4.0
hitman: absolution (professional edition) -xbox 360,1,0,0,1,6,8,4.375
"sades spirit wolf 7.1 surround stereo sound usb computer gaming headset with microphone,over-the-ear noise isolating,breathing led light for pc gamers (black white)",0,0,1,1,6,8,4.625
justice league heroes - xbox,0,0,3,3,2,8,3.875
dungeon siege: throne of agony - sony psp,0,0,1,0,7,8,4.75
shin megami tensei iv: apocalypse - nintendo 3ds,0,0,0,2,6,8,4.75
tony hawk's underground 2 remix - sony psp,0,0,1,2,5,8,4.5
tomb raider chronicles,1,0,1,4,2,8,3.75
240 stronghold kingdoms crowns: stronghold kingdoms [instant access],2,1,1,0,4,8,3.375
mafia iii deluxe edition - ps4 [digital code],0,1,2,0,5,8,4.125
"hydra performance wireless controller compatible with sony playstation ps2, black",0,0,1,1,6,8,4.625
bioshock 2 [download],1,1,2,1,3,8,3.5
wwf warzone,3,1,0,1,3,8,3.0
just cause - pc,4,0,3,0,1,8,2.25
ben 10 omniverse - nintendo wii u,0,1,1,0,6,8,4.375
taito legends - playstation 2,0,0,2,1,5,8,4.375
nanostray - nintendo ds,0,0,0,6,2,8,4.25
psp headphones with remote control (white),0,1,1,2,4,8,4.125
need for speed most wanted - xbox,0,0,1,3,4,8,4.375
venetica - pc,0,0,2,5,1,8,3.875
star wars episode i: jedi power battles,1,0,3,1,3,8,3.625
the sims 2 pets - nintendo ds,0,2,2,2,2,8,3.5
playstation 2 8mb memory card (black),0,0,2,1,5,8,4.375
darkstar one (dvd-rom) - pc,1,0,1,3,3,8,3.875
rayman 2: revolution,0,1,0,2,5,8,4.375
nintendo isabelle summer outfit amiibo - nintendo wii u,0,0,0,1,7,8,4.875
war gods,1,1,1,1,4,8,3.75
hori 3ds protector and pouch set (super mario 3d land version),1,1,2,3,1,8,3.25
sega game gear,2,1,0,3,2,8,3.25
nintendo ds lite travel kit,0,0,2,2,4,8,4.25
the technomancer - xbox one,2,0,3,1,2,8,3.125
lego friends - nintendo 3ds,0,0,0,0,8,8,5.0
delta force black hawk down - playstation 2,1,1,1,1,4,8,3.75
assassin's creed iii with steelbook,0,1,2,2,3,8,3.875
disney's little mermaid: ariel's undersea adventure - nintendo ds,0,0,1,0,7,8,4.75
assassin's creed iii with steelbook,0,1,0,1,6,8,4.5
retro-bit retroport nes to snes cartridge adapter - super nes,0,0,1,0,7,8,4.75
icewind dale: heart of winter - pc,0,0,4,2,2,8,3.75
battle chess - nintendo nes,0,1,1,0,6,8,4.375
star wars episode iii revenge of the sith - nintendo ds,2,0,1,3,2,8,3.375
mark of the ninja [online game code],0,0,1,2,5,8,4.5
"skylanders spyro's adventure triple character pack (ignitor, warnado, camo)",0,0,0,2,6,8,4.75
skylanders spyro's adventure: ignitor,0,0,0,2,6,8,4.75
regular show: mordecai and rigby in 8-bit land - nintendo 3ds,1,0,1,3,3,8,3.875
star wars: galactic battlegrounds - pc,0,0,3,4,1,8,3.75
commando,0,0,1,1,6,8,4.625
infected - sony psp,0,1,1,2,4,8,4.125
shin megami tensei devil summoner - playstation 2,0,0,3,1,4,8,4.125
makai kingdom - playstation 2,0,0,2,3,3,8,4.125
dead head fred - sony psp,0,0,0,3,5,8,4.625
keepsake - pc,0,1,0,3,4,8,4.25
rome: total war gold edition - pc,1,1,2,0,4,8,3.625
major league baseball 2k6 - xbox 360,1,1,4,0,2,8,3.125
star wars galaxies: the total experience - pc,4,2,1,0,1,8,2.0
rocksmith 2014 edition - pc/mac (cable included),1,0,1,1,5,8,4.125
ncaa football 2002 [playstation],0,0,0,2,6,8,4.75
persona 5 - playstation 3 standard edition,0,0,0,1,7,8,4.875
"warhammer 40,000 dawn of war gold edition - pc",0,0,2,2,4,8,4.25
galgun: double peace - playstation 4,0,0,1,2,5,8,4.5
pdp donkey kong display,0,0,1,2,5,8,4.5
vectorman,0,0,0,1,7,8,4.875
super double dragon,0,1,1,1,5,8,4.25
just dance 2014 - playstation 3,0,0,0,0,8,8,5.0
xbox kinect adapter for xbox one s and windows 10 pc,1,1,3,0,3,8,3.375
halo reach - xbox 360,0,1,0,0,7,8,4.625
final fantasy xiv: a realm reborn collector's edition - playstation 3,3,0,0,0,5,8,3.5
official gamer essentials kit for wii u - black,0,0,0,2,6,8,4.75
star wars the force unleashed: ultimate sith edition -xbox 360,0,0,1,3,4,8,4.375
nhl 17 - xbox one,4,3,1,0,0,8,1.625
tiger woods pga tour 14: masters historic edition -xbox 360,0,1,0,2,5,8,4.375
thrustmaster vg y-250x gaming headset,0,2,6,0,0,8,2.75
ps2 controller extension cable,0,0,1,0,7,8,4.75
tom clancy's splinter cell: double agent - pc,2,1,0,3,2,8,3.25
the matrix: path of neo - xbox,0,2,0,3,3,8,3.875
condemned: criminal origins (dvd) - pc,0,1,3,2,2,8,3.625
quake ii,0,0,2,2,4,8,4.25
final fantasy vii,0,0,2,0,6,8,4.5
harry potter and the sorcerer's stone - pc,0,2,1,2,3,8,3.75
valkyrie profile,0,0,1,3,4,8,4.375
cannon spike,1,0,2,1,4,8,3.875
wcw vs. nwo: thunder,2,0,3,1,2,8,3.125
medievil,0,0,0,1,7,8,4.875
icewind dale 3 in 1 boxset (icewind dale / icewind dale: heart of winter / icewind dale ii),1,0,0,1,6,8,4.375
madden nfl 07 - playstation 2,0,2,2,3,1,8,3.375
serious sam 2 - pc,1,0,0,3,4,8,4.125
action replay powersaves cheat device for 3ds games,0,0,3,0,5,8,4.25
teenage mutant ninja turtles: the hyperstone heist,0,1,1,3,3,8,4.0
armored core 2,1,0,0,4,3,8,4.0
batman: arkham asylum game of the year edition,0,0,1,2,5,8,4.5
battlefield 1 [online game code],2,1,0,1,4,8,3.5
rampage total destruction - gamecube,1,1,0,3,3,8,3.75
yu-gi-oh nightmare troubadour - nintendo ds,0,0,0,1,7,8,4.875
batman begins - gamecube,0,0,2,2,4,8,4.25
unreal tournament - playstation 2,0,3,1,0,4,8,3.625
datel electronics dus0111-i 64mb max memory for ps2,4,1,0,1,2,8,2.5
xbox 360 rock band 3 wireless fender telecaster player's edition - light blue,0,0,2,4,2,8,4.0
tom clancy's ghost recon wildlands (deluxe edition) - xbox one,0,1,2,1,4,8,4.0
astro gaming a50 wireless dolby gaming headset - black/green - xbox one + pc,0,0,0,4,4,8,4.5
hyperkin retron 2 gaming console for snes/ nes (gray),0,0,0,1,7,8,4.875
company of heroes - pc,0,0,1,2,5,8,4.5
atgames sega genesis classic game console,2,1,1,2,2,8,3.125
nintendo wii remote plus - blue,0,0,0,1,7,8,4.875
duke nukem: total meltdown,2,2,0,1,3,8,3.125
red star - playstation 2,0,0,1,3,4,8,4.375
jojo's bizarre adventure-all star battle,0,0,0,1,7,8,4.875
gun - pc,2,0,2,0,4,8,3.5
house of 1000 doors 2 [download],0,0,0,2,6,8,4.75
mlb the show 16 mvp edition - playstation 4,0,0,0,0,8,8,5.0
il-2 sturmovik: 1946 - pc,0,0,0,0,8,8,5.0
rhythm thief,0,0,0,3,5,8,4.625
assassin's creed chronicles - playstation 4 standard edition,0,1,1,2,4,8,4.125
immortal cities: children of the nile - pc,3,0,2,1,2,8,2.875
ultimate spider-man,1,0,0,3,4,8,4.125
"gunnar gaming and computer eyewear /intercept, amber tint - patented lens, reduce digital eye strain, block 65% of harmful blue light",0,0,2,2,4,8,4.25
senran kagura estival versus - endless summer edition - playstation vita,0,0,0,1,7,8,4.875
silent hunter: wolves of the pacific - pc,1,0,2,3,2,8,3.625
fifa street - xbox 360,0,0,2,1,5,8,4.375
titan quest immortal throne expansion pack - pc,1,0,0,5,2,8,3.875
street fighter alpha 3,0,0,1,0,7,8,4.75
tourist trophy - playstation 2,0,0,1,2,5,8,4.5
ms. pac-man,0,0,0,0,8,8,5.0
ratatouille - playstation 2,0,0,0,2,6,8,4.75
field commander - sony psp,0,2,0,3,3,8,3.875
the sims 3 pets [download],1,0,1,2,4,8,4.0
crazy taxi: fare wars - sony psp,0,0,2,0,6,8,4.5
cold fear - xbox,0,1,1,2,4,8,4.125
fantastic four: rise of the silver surfer,0,0,1,0,7,8,4.75
skylanders: spyro's adventure - xbox 360,0,0,0,2,6,8,4.75
pirates of the caribbean: at world's end - playstation 3,1,2,2,1,2,8,3.125
koudelka - playstation,0,0,2,3,3,8,4.125
pokemon puzzle league,0,0,1,0,7,8,4.75
tomee game boy advance to gamecube link cable,1,0,1,2,4,8,4.0
sennheiser x320 xbox headset (rca to tv connectors),0,0,4,1,3,8,3.875
dungeons and dragons neverwinter nights: the complete collection,1,0,1,0,6,8,4.25
the bigs - xbox 360,0,0,0,1,7,8,4.875
viewtiful joe 2 - gamecube,0,0,0,1,7,8,4.875
air conflicts pacific carriers - playstation 3,2,1,1,1,3,8,3.25
dance dance revolution,0,0,1,2,5,8,4.5
cradle of athena / jewel master egypt double pack - nintendo ds,0,0,0,1,7,8,4.875
nintendo ds browser,0,1,2,5,0,8,3.5
geltabz performance thumb grips - xbox one and xbox 360,0,0,0,2,6,8,4.75
monster high: ghoul spirit - nintendo wii,0,1,1,1,5,8,4.25
namco museum - playstation 2,0,0,1,4,3,8,4.25
true crime: new york city,1,1,2,1,3,8,3.5
ncis,1,2,1,0,4,8,3.5
nfl 2k - sega dreamcast,0,1,0,3,4,8,4.25
mystery case files: huntsville,0,0,0,3,5,8,4.625
elder scrolls iv: shivering isles - pc,0,0,0,4,4,8,4.5
singstar pop - playstation 2,0,0,1,2,5,8,4.5
port royale 3: pirates & merchants - xbox 360,1,2,1,2,2,8,3.25
wwe all stars 3ds,0,1,1,2,4,8,4.125
homeworld cataclysm - pc,1,0,2,0,5,8,4.0
xbox one special edition halo: the master chief collection 500gb bundle,1,0,1,1,5,8,4.125
battlefield 4: premium season pass - ps3/ ps4 [digital code],3,1,0,0,4,8,3.125
teenage mutant ninja turtles 3: mutant nightmare - playstation 2,1,0,2,1,4,8,3.875
transformers the game - xbox 360,2,0,4,0,2,8,3.0
i spy castle - nintendo ds,0,0,1,2,5,8,4.5
the simpsons road rage,0,2,2,2,2,8,3.5
castlevania curse of darkness - xbox,0,0,0,2,6,8,4.75
mlb 07 the show,0,0,0,4,4,8,4.5
smuggler's run 2: hostile territory,0,2,1,1,4,8,3.875
riviera: the promised land - sony psp,1,0,1,3,3,8,3.875
super star wars: the empire strikes back,0,0,0,3,5,8,4.625
doom,0,0,1,3,4,8,4.375
madden nfl 2001,0,0,0,2,6,8,4.75
half-life 2: game of the year edition - pc,3,0,0,0,5,8,3.5
committed: mystery at shady pines [download],0,1,1,3,3,8,4.0
nintendo 64 controller - black,0,1,2,0,5,8,4.125
rhythm heaven fever - nintendo wii,0,1,1,1,5,8,4.25
"nhl 2001 (ps2, refurb)",0,0,1,3,4,8,4.375
battlefield 2 modern combat - xbox,0,2,2,3,1,8,3.375
dynasty warriors next - playstation vita,0,0,2,1,5,8,4.375
zettaguard internal slim hard disk drive for xbox 360 (250gb),0,0,0,0,8,8,5.0
wii mini with mario kart wii game - red,2,0,1,0,5,8,3.75
lego star wars: the force awakens - playstation vita standard edition,0,0,0,2,6,8,4.75
donkey kong classics,1,0,1,2,4,8,4.0
tom clancy's rainbow six vegas - sony psp,1,1,2,1,3,8,3.5
"skylanders spyro adventure triple character pack (whirlwind, double trouble, drill sergeant)",0,0,0,4,4,8,4.5
skylanders spyro's adventure: drill sergeant,0,1,0,3,4,8,4.25
doom collector's edition - pc,1,0,3,1,3,8,3.625
grand kingdom - playstation vita,0,0,1,1,6,8,4.625
the revenge of shinobi,0,0,2,1,5,8,4.375
the bureau: xcom declassified,0,2,0,1,5,8,4.125
sonic the hedgehog 4 episode 1 [download],1,2,1,1,3,8,3.375
nintendo ds lite ac adapter,0,0,0,0,8,8,5.0
playstation 2 slim silver,0,1,0,1,6,8,4.5
hidden & dangerous 2 - pc,2,1,0,3,2,8,3.25
boiling point,0,3,0,2,3,8,3.625
circle pad pro - nintendo 3ds accessory (3ds console not included),1,0,1,2,4,8,4.0
command & conquer: red alert 2,0,0,0,2,6,8,4.75
pdp titanfall 2 official marauder six four communicator for xbox one,0,0,3,2,3,8,4.0
the nightmare before christmas: oogie's revenge,0,0,0,2,6,8,4.75
blazing angels 2 secret missions -xbox 360,1,0,0,2,5,8,4.25
street fighter x tekken: special edition -xbox 360,2,1,2,2,1,8,2.875
darksiders ii - pc,1,2,0,2,3,8,3.5
sorcery saga: curse of the great curry god limited edition - playstation vita limited edition edition,0,2,1,1,4,8,3.875
mario & sonic sochi 2014 olympic winter games with blue wii remote plus - wii u,0,1,1,2,4,8,4.125
wwe day of reckoning 2 - gamecube,1,1,0,2,4,8,3.875
angry birds: star wars - xbox one,1,1,2,0,4,8,3.625
nintendo switch travel pouch (zelda breath of the wild edition) officially licensed by nintendo,1,0,1,3,3,8,3.875
major league baseball 2k12 - xbox 360,0,1,0,5,2,8,4.0
ready to rumble boxing: round 2,1,0,1,2,4,8,4.0
mercury,0,1,3,2,2,8,3.625
wwe wrestlemania xxi become a legend - xbox,3,2,2,0,1,8,2.25
bangai-o - sega dreamcast,0,0,0,2,6,8,4.75
star wars: the old republic 60-day pre-paid time card - pc,0,0,0,2,6,8,4.75
fifa 14 legacy edition - playstation vita,0,0,1,1,6,8,4.625
sacra terra: angelic night [download],0,1,0,1,6,8,4.5
garfield's nightmare - nintendo ds,0,0,0,4,4,8,4.5
pdp disney infinity series 2 power disc album - not machine specific,0,0,1,1,6,8,4.625
urban reign - playstation 2,1,0,0,6,1,8,3.75
frozen: olaf's quest - nintendo 3ds,1,1,0,2,4,8,3.875
tiger woods pga tour 13 - playstation 3,0,1,0,3,4,8,4.25
king of fighters 98: ultimate match,0,0,0,2,6,8,4.75
city of villains - pc,0,1,3,1,3,8,3.75
swat: global strike team,0,2,2,3,1,8,3.375
gitaroo man,0,0,0,1,7,8,4.875
disney infinity 3.0 edition: sam flynn figure,0,0,0,2,6,8,4.75
"levelup playstation alloy game storage tower, black",0,0,0,1,7,8,4.875
star wars: the force unleashed nds,0,2,2,2,2,8,3.5
mario is missing!,3,1,1,0,3,8,2.875
powera spectra illuminated controller for xbox one,0,0,0,3,5,8,4.625
quantum theory - xbox 360,1,1,2,1,3,8,3.5
hitman collection,0,2,0,2,4,8,4.0
f1 2014 (formula 1) - playstation 3,1,0,0,1,6,8,4.375
psp charger grip,0,0,0,4,4,8,4.5
breakdown - xbox,0,0,3,5,0,8,3.625
space channel 5 dc,0,0,2,3,3,8,4.125
major league baseball 2k11 - playstation 3,0,0,1,1,6,8,4.625
harvest moon ds cute,0,0,0,0,8,8,5.0
turbo grafx 16 system - video game console,0,0,0,3,5,8,4.625
true crime: streets of l.a.,0,0,3,2,3,8,4.0
medal of honor rising sun - gamecube,0,1,2,1,4,8,4.0
extreme g,1,0,0,4,3,8,4.0
xbox one madden nfl 15 500gb bundle,2,2,3,0,1,8,2.5
midnight club 2 - xbox,0,0,1,2,5,8,4.5
afrika - playstation 3,0,2,1,2,3,8,3.75
far cry compliation - xbox 360,0,0,0,3,5,8,4.625
"back to the future, part ii and iii",6,1,0,0,1,8,1.625
rampage world tour,0,1,1,1,5,8,4.25
thief collection (netherlands),2,0,0,2,4,8,3.75
hidden mysteries: salem secrets - witch trials of 1692 - pc,0,2,0,0,6,8,4.25
toukiden: kiwami - playstation vita,0,0,0,2,6,8,4.75
life is strange - episode 1 [online game code],1,1,0,0,6,8,4.125
sid meiers civilization iv: the complete edition [download],1,1,1,4,1,8,3.375
the sims 3: world adventures - expansion pack  [download],1,0,1,1,5,8,4.125
warriors orochi 3 ultimate - playstation 4,0,0,1,2,5,8,4.5
ncaa football 11 - xbox 360,1,0,2,2,3,8,3.75
double dragon advance,0,0,2,1,5,8,4.375
slingo quest (nintendo ds),0,0,2,1,5,8,4.375
skylanders trap team: midnight museum dark element expansion pack,0,1,0,0,7,8,4.625
grand theft auto: collector's edition - playstation,0,0,0,2,6,8,4.75
drawn to life: spongebob squarepants,0,0,1,1,6,8,4.625
knights in the nightmare - nintendo ds,0,0,1,5,2,8,4.125
conflict:  desert storm - playstation 2,0,0,0,3,5,8,4.625
pinball hall of fame: the williams collection - playstation 3,1,0,1,1,5,8,4.125
tom clancy's splinter cell: pandora tomorrow - pc,2,1,1,2,2,8,3.125
spawn armageddon,1,1,1,2,3,8,3.625
alekhine's gun - playstation 4,3,2,1,1,1,8,2.375
rise of nations: thrones & patriots expansion pack - pc,1,0,1,2,4,8,4.0
la pucelle: tactics,0,0,3,2,3,8,4.0
wii wired sensebar,0,0,0,2,6,8,4.75
rygar: the battle of argus - nintendo wii,0,2,2,0,4,8,3.75
divinity ii: ego draconis,0,1,4,2,1,8,3.375
the crew - xbox 360,1,2,2,0,3,8,3.25
the sims 2: best of business collection - pc,0,0,0,0,8,8,5.0
dsi/ds lite universal transporter carrying case - cobalt blue,0,0,0,3,5,8,4.625
thor: god of thunder - nintendo wii,0,0,1,1,6,8,4.625
samurai shodown anthology - nintendo wii,0,1,0,3,4,8,4.25
thousand arms,0,1,0,2,5,8,4.375
fear effect,0,0,4,0,4,8,4.0
cta digital wii sports resort 8-in-1 sports pack (white),0,0,0,3,5,8,4.625
nba 2k15 - playstation 4,0,0,2,0,6,8,4.5
bad dudes - nintendo nes,0,1,1,0,6,8,4.375
8 gb sony pro duo (mark 2) memory stick for psp,0,0,0,3,5,8,4.625
disney infinity 3.0 edition starter pack - playstation 3,0,1,0,2,5,8,4.375
lionheart: legacy of the crusader - pc,1,3,1,3,0,8,2.75
rainbow six 3: black arrow - xbox,0,0,2,4,2,8,4.0
syphon filter: the omega strain,2,0,3,0,3,8,3.25
ridge racer 3d - nintendo 3ds,0,0,0,6,2,8,4.25
hitman 2,0,0,3,1,4,8,4.125
official nintendo wii comfort racing wheel - black,0,0,0,3,5,8,4.625
jewels of tropic lost island - nintendo ds,0,1,2,2,3,8,3.875
tiger woods pga tour 2004,2,0,0,3,3,8,3.625
ruse - playstation 3,0,0,2,3,3,8,4.125
dreamcast collection - xbox 360,1,1,2,1,3,8,3.5
gothic ii - pc,0,0,0,3,5,8,4.625
nintendo official expedition case for 3ds - blue,0,0,0,4,4,8,4.5
deception iv: the nightmare princess - playstation 4,0,0,1,2,5,8,4.5
tony hawk's pro skater 5 - standard edition - xbox one,6,0,0,0,2,8,2.0
grand theft auto: london mission pack,0,0,1,2,5,8,4.5
logitech wii vantage usb microphone,0,2,2,0,4,8,3.75
ac/dc live: rock band track pack - xbox 360,0,0,2,2,4,8,4.25
sonic boom: fire & ice - nintendo 3ds,0,1,2,2,3,8,3.875
pac-man - classic nes series,1,0,5,0,2,8,3.25
fifa soccer 09 - playstation 3,0,0,0,3,5,8,4.625
sniper elite iii ultimate edition - xbox one,0,0,0,2,6,8,4.75
one piece unlimited world red: day 1 edition - playstation 3,0,0,0,0,8,8,5.0
sega gt,0,0,1,3,4,8,4.375
divinity: original sin enhanced edition - xbox one,0,0,4,3,1,8,3.625
oddworld: abe's exoddus,0,0,0,1,7,8,4.875
astro boy omega factor,0,0,0,4,4,8,4.5
ricochet xtreme [download],0,1,2,2,3,8,3.875
lara croft and the temple of osiris + season's pass,2,0,0,0,6,8,4.0
sword of the berserk: guts' rage - sega dreamcast,0,0,4,1,3,8,3.875
the price is right - nintendo wii,0,2,2,3,1,8,3.375
advent rising - xbox,0,1,1,4,2,8,3.875
disney infinity 3.0 edition: quorra figure,0,0,1,1,6,8,4.625
dancedancerevolution bundle - nintendo wii,0,0,1,4,3,8,4.25
the sims 3: fast lane stuff - pc/mac,1,1,1,0,5,8,3.875
batman arkham knight - season pass - playstation 4 [digital code],1,1,1,1,4,8,3.75
kung fu panda - nintendo wii,0,2,4,2,0,8,3.0
kung fu panda - playstation 3,0,0,0,2,6,8,4.75
gen classic n64 controller grey,0,0,1,3,4,8,4.375
minecraft game voucher - playstation vita,0,0,0,1,7,8,4.875
raiden iv limited edition w/ultimate of raiden soundtrack,0,0,0,2,6,8,4.75
lufia ii: rise of the sinistrals,0,1,0,1,6,8,4.5
advance wars 2: black hole rising,0,1,1,0,6,8,4.375
xiii - nintendo gamecube,0,0,0,4,4,8,4.5
half-life (platinum collection) (second edition),0,0,0,1,7,8,4.875
tom clancy's h.a.w.x 2 - playstation 3,0,0,1,3,4,8,4.375
way of the samurai 3 - xbox 360,2,0,3,3,0,8,2.875
centipede: infestation - nintendo 3ds,0,0,3,1,4,8,4.125
who wants to be a millionaire? - nintendo wii,0,1,0,0,7,8,4.625
nokia n-gage - game system / cellular phone,3,1,1,2,1,8,2.625
need for speed 3: hot pursuit,1,0,1,2,4,8,4.0
megamind: ultimate showdown - playstation 3,0,1,1,1,5,8,4.25
guitar hero metallica - nintendo wii,0,0,0,2,6,8,4.75
toy soldiers: war chest hall of fame edition - playstation 4 standard edition,0,0,1,1,6,8,4.625
dj hero 2 turntable bundle - playstation 3,0,0,2,0,6,8,4.5
trine [download],1,0,2,3,2,8,3.625
tetris ultimate - nintendo 3ds,0,1,0,3,4,8,4.25
skylanders superchargers racing starter pack - wii,1,0,1,1,5,8,4.125
fossil fighters frontier,0,3,1,1,3,8,3.5
xbox one console + kinect,1,0,1,0,6,8,4.25
warhammer online: age of reckoning collector's edition - pc,0,2,0,4,2,8,3.75
margrave: the blacksmith's daughter [download],0,1,2,4,1,8,3.625
final fantasy xi vana'diel collection 2008 - pc (atomic),0,3,0,3,2,8,3.5
aquascape streets of rage,0,0,1,1,6,8,4.625
tom clancy's rainbow six,0,0,0,2,6,8,4.75
velvet assassin [download],0,2,1,2,3,8,3.75
midway arcade treasures - xbox,1,0,2,3,2,8,3.625
luigi's mansion,0,0,0,0,8,8,5.0
lord of the rings: the fellowship of the ring,0,2,2,3,1,8,3.375
raven squad - xbox 360,2,0,2,2,2,8,3.25
halo reach wireless xbox 360 headset,0,0,1,2,5,8,4.5
jeopardy - nintendo ds,0,1,2,1,4,8,4.0
madden nfl 09 20th anniversary collectors edition - playstation 3,0,0,6,2,0,8,3.25
command and conquer generals: deluxe edition - pc,0,0,0,2,6,8,4.75
legend of spyro: dawn of the dragon,1,2,0,0,5,8,3.75
star wars clone wars - xbox,0,2,2,1,3,8,3.625
xbox 360 repair kit - x-clamp hardware replacement,0,0,0,0,8,8,5.0
spider-man: web of shadows - nintendo ds,0,0,0,2,6,8,4.75
grand theft auto: the trilogy (grand theft auto 3 / grand theft auto: vice city / grand theft auto: san andreas),1,0,2,1,4,8,3.875
nhl 09 - xbox 360,0,1,0,1,6,8,4.5
james bond 007: nightfire - pc,0,1,4,0,3,8,3.625
innocent life: a futuristic harvest moon special edition - playstation 2,0,0,2,0,6,8,4.5
backyard wrestling: don't try this at home ( ps2),1,0,2,2,3,8,3.75
star trek: starfleet command - pc,0,2,1,3,2,8,3.625
breath of fire,0,0,1,0,7,8,4.75
pokemon channel,1,0,1,2,4,8,4.0
big bang mini - nintendo ds,0,0,2,0,6,8,4.5
nfl street - playstation 2,0,0,0,3,5,8,4.625
blitz: the league ii - playstation 3,1,0,1,3,3,8,3.875
gunstar heroes - sega genesis,0,0,0,0,8,8,5.0
joint operations: typhoon rising - pc,1,0,0,3,4,8,4.125
sony ps3 street fighter iv fightstick tournament edition,0,0,0,2,6,8,4.75
gamilys 64 mb memory card  compatible for playstation 2,4,0,0,2,2,8,2.75
ogre battle 64,1,0,0,1,6,8,4.375
tom clancy's the division - collector's edition - xbox one,0,1,0,2,5,8,4.375
quest 64,1,3,0,2,2,8,3.125
monopoly streets - xbox 360,0,1,2,3,2,8,3.75
the lion king,0,0,0,1,7,8,4.875
the sims 3 - playstation 3,0,0,0,2,6,8,4.75
the sims 3 - nintendo wii,1,1,1,0,5,8,3.875
call of duty: black ops,0,0,0,3,5,8,4.625
thrustmaster ferrari gt experience racing wheel for ps3 and pc,2,0,0,6,0,8,3.25
ice age: dawn of the dinosaurs - playstation 3,0,0,1,1,6,8,4.625
tom clancy's ghost recon jungle storm - playstation 2,0,2,3,1,2,8,3.375
guitar hero aerosmith wireless bundle - playstation 2,2,2,2,2,0,8,2.5
the crew - pc,1,0,4,1,2,8,3.375
grand theft auto: san andreas - xbox 360,0,0,2,2,4,8,4.25
ultimate ninja 4: naruto shippuden,0,1,0,0,7,8,4.625
tom clancy's rainbow six siege - pc,3,1,0,0,4,8,3.125
batman forever,4,2,0,1,1,8,2.125
kirby's dreamland 2,0,0,0,1,7,8,4.875
return to popolocrois: a story of seasons fairytale - nintendo 3ds,0,0,1,1,6,8,4.625
bomberman 64,1,1,0,2,4,8,3.875
rogue ops,1,2,2,2,1,8,3.0
nintendo entertainment system,2,0,2,0,4,8,3.5
company of heroes: gold edition,2,0,2,4,0,8,3.0
"ortz xbox one controller charger + free ac wall charger adapter & 2x rechargeable batteries - charging base for 2x controllers - play and charge kit system - dual dock charging station - best accessories, top quality - 1 year warranty",0,1,1,1,5,8,4.25
assassin’s creed syndicate - pc,2,0,1,1,4,8,3.625
nyko media remote - xbox one,0,0,2,2,4,8,4.25
nancy drew: the captive curse - pc/mac,0,1,1,2,4,8,4.125
inkling squid amiibo - japan import (splatoon series),0,0,1,0,7,8,4.75
the price is right 2010 edition - nintendo wii,1,1,0,1,5,8,4.0
gladius - playstation 2,0,0,1,1,6,8,4.625
mega man zero,0,0,1,3,4,8,4.375
death by degrees - playstation 2,2,1,1,2,2,8,3.125
dsi -18-in-1 starter kit - white,0,1,1,2,4,8,4.125
just cause 3 - pc [digital code] [online game code],2,0,0,3,3,8,3.625
sherlock holmes: the awakened,1,1,2,2,2,8,3.375
t2 (terminator 2): the arcade game,0,0,0,3,5,8,4.625
the treasures of mystery island: the ghost ship (mac) [download],0,1,2,2,3,8,3.875
dino crisis 3,2,1,3,1,1,8,2.75
star trek: armada - pc,1,1,3,1,2,8,3.25
spider-man: web of shadows - pc,1,0,2,4,1,8,3.5
3ds xl retro nes edition system,0,0,0,0,8,8,5.0
rocket league [online game code],1,0,0,1,6,8,4.375
resistance greatest hits dual pack - playstation 3,0,0,1,1,6,8,4.625
conflict: vietnam - xbox,1,0,1,3,3,8,3.875
cities: skylines [online game code],0,0,0,1,7,8,4.875
wipeout fusion,0,0,1,4,3,8,4.25
dark fall: lights out - pc,0,0,1,7,0,8,3.875
front mission evolved - xbox 360,1,1,3,1,2,8,3.25
cradle of rome - nintendo ds,1,0,0,2,5,8,4.25
mario and sonic at the olympic winter games - nintendo ds,0,0,0,3,5,8,4.625
the sims makin' magic expansion pack - pc,1,0,1,2,4,8,4.0
die hard vendetta,1,0,1,1,5,8,4.125
17-in-1 bundle pack for nintendo ds lite,0,0,1,1,6,8,4.625
teenage mutant ninja turtles: tournament fighters,0,2,2,1,3,8,3.625
damnation - pc,4,1,1,0,2,8,2.375
rampage - nintendo nes,0,0,1,2,5,8,4.5
the sims medieval [download],1,0,0,4,3,8,4.0
skylanders superchargers: vehicle dive bomber character pack,0,0,0,2,6,8,4.75
agatha christie: evil under the sun - pc,1,2,1,1,3,8,3.375
rapala fishing frenzy - playstation 3,1,2,2,0,3,8,3.25
wwf wrestlemania: the arcade game - nintendo super nes,2,0,2,3,1,8,3.125
cabela's big game hunter 2010 with gun bundle,0,1,1,2,4,8,4.125
looney tunes: duck amuck - nintendo ds,0,2,1,2,3,8,3.75
battlefield 3 - limited edition - xbox 360,0,0,0,4,4,8,4.5
call of duty: advanced warfare (gold edition) - xbox 360,0,0,0,1,7,8,4.875
socom: tactical strike - sony psp,0,0,0,1,7,8,4.875
2x xbox thumbsticks for xbox one controllers (fits ps4 thumbsticks for dualshock 4!) by onesoul [black],0,1,0,2,5,8,4.375
ea sports mma - xbox 360,0,0,3,3,2,8,3.875
ps4 stand - playstation 4 console vertical stand - premium ps4 accessories,0,0,1,1,6,8,4.625
dragon ball: raging blast - playstation 3,1,0,1,2,4,8,4.0
nintendo 3ds charging cradle w/ac adapter,1,0,0,1,6,8,4.375
tomb raider anniversary,2,1,2,1,2,8,3.0
wing wireless controller for wii,1,1,2,1,3,8,3.5
star wars trilogy: apprentice of the force,0,0,3,1,4,8,4.125
"aweek® plastic controller hand grip holder joypad stand case gaming case handle stand for new nintendo 3ds ll/ new 3ds xl, black (hand grip)",0,1,3,1,3,8,3.75
disgaea 4: a promise unforgotten (premium edition) - playstation 3,0,0,0,2,6,8,4.75
bit.trip saga 3ds,0,0,2,4,2,8,4.0
"skylanders trap team: tech, magic, & earth trap - triple trap pack",0,0,0,1,7,8,4.875
megaman & bass,0,0,1,4,3,8,4.25
eastvita new charger dock + 4 x battery for nintendo wii remote,1,0,1,1,5,8,4.125
assassin's creed ii (original edition),0,1,0,1,6,8,4.5
last rebellion - playstation 3,2,1,2,1,2,8,3.0
x-men: mutant apocalypse,0,0,2,1,5,8,4.375
kontrolfreek fps ultra,0,0,1,0,7,8,4.75
turning point: fall of liberty - playstation 3,1,2,3,0,2,8,3.0
guitar hero smash hits - xbox 360,0,1,0,1,6,8,4.5
retro game challenge - nintendo ds,0,0,1,2,5,8,4.5
wolfenstein the old blood - xbox one digital code,0,0,0,3,5,8,4.625
beach spikers volleyball ngc,0,1,2,3,2,8,3.75
batman returns - sega genesis,1,2,1,2,2,8,3.25
the simpsons: bart vs. the space mutants,1,0,1,0,6,8,4.25
naruto: the broken bond - xbox 360,0,0,0,2,6,8,4.75
"hde 2 pack usb charger power cable for nintendo 3ds xl, 3ds, 2ds, dsi xl, dsi, new 3ds xl",0,0,0,1,7,8,4.875
front mission evolved - pc,2,1,2,2,1,8,2.875
ar tonelico ii: melody of metafalica,1,2,3,1,1,8,2.875
super monkey ball jr.,0,0,1,2,5,8,4.5
operation flashpoint: red river - pc,1,2,1,3,1,8,3.125
limited-edition wii sports resort bundle with two wii motionplus,0,0,0,2,6,8,4.75
wild arms,0,0,1,3,4,8,4.375
disgaea: afternoon of darkness - sony psp,0,0,1,1,6,8,4.625
phineas and ferb: across the 2nd dimension - nintendo wii,0,0,1,2,5,8,4.5
mega man x command mission - playstation 2,0,1,1,1,5,8,4.25
mortal kombat deadly alliance,0,0,0,4,4,8,4.5
biggest loser - nintendo wii,0,0,1,4,3,8,4.25
jurassic park: operation genesis,0,0,0,5,3,8,4.375
shaun white snowboarding - xbox 360,2,1,0,2,3,8,3.375
shaun white snowboarding road trip - nintendo wii,0,0,0,2,6,8,4.75
disney infinity 3.0 edition: star wars rebels kanan jarrus figure,0,0,0,0,8,8,5.0
band hero nds bundle,0,1,0,1,6,8,4.5
toon link amiibo - japan import (super smash bros series),0,0,0,1,7,8,4.875
soldier of fortune 2: double helix,1,1,2,2,2,8,3.375
mario pinball land,0,2,1,3,2,8,3.625
motorcycle club - playstation 4,2,1,1,0,4,8,3.375
insten battery charging dock for remote control + 4 rechargeable 2800mah battery compatible with nintendo wii / wii u,2,0,1,3,2,8,3.375
escape dead island - playstation 3,1,1,1,1,3,7,3.5714285714285716
the vanishing of ethan carter [online game code],1,0,2,2,2,7,3.5714285714285716
playstation 2 usb headset,1,1,1,3,1,7,3.2857142857142856
king of fighters 2000 & 2001 - playstation 2,0,0,1,1,5,7,4.571428571428571
toad amiibo - japan import (super mario bros series),1,0,1,0,5,7,4.142857142857143
medal of honor european assault,0,0,0,2,5,7,4.714285714285714
pdp wired controller for xbox one & pc - black,0,1,1,2,3,7,4.0
skate 2 - playstation 3,1,1,1,2,2,7,3.4285714285714284
red faction (jewel case) - pc,0,1,0,4,2,7,4.0
yu-gi-oh! dark duel stories,0,0,2,1,4,7,4.285714285714286
coded arms - sony psp,1,1,1,0,4,7,3.7142857142857144
the technomancer - playstation 4,0,2,1,3,1,7,3.4285714285714284
beetle adventure racing,0,0,0,3,4,7,4.571428571428571
wwe smackdown! vs raw 2006 (psp),0,1,0,3,3,7,4.142857142857143
psp pro gamers's kit (color may vary),1,0,0,0,6,7,4.428571428571429
dance on broadway - nintendo wii,0,3,0,3,1,7,3.2857142857142856
fallout 3,3,0,2,0,2,7,2.7142857142857144
"sakura wars: so long, my love - nintendo wii",0,0,0,3,4,7,4.571428571428571
destiny ghost edition - playstation 4,3,0,1,1,2,7,2.857142857142857
scooby-doo and the cyber chase,0,0,1,1,5,7,4.571428571428571
tekken - playstation,0,1,0,3,3,7,4.142857142857143
"nintendo 3ds, pearl pink",0,0,0,1,6,7,4.857142857142857
marvel ultimate alliance - pc,1,2,1,0,3,7,3.2857142857142856
afterglow aw.2 lightchuck for wii - green,1,2,2,1,1,7,2.857142857142857
titanfall 2 deluxe edition - playstation 4,0,0,0,4,3,7,4.428571428571429
spider-man: shattered dimensions - nintendo wii,0,1,1,0,5,7,4.285714285714286
docomodake boing! - nintendo ds,0,0,2,1,4,7,4.285714285714286
command & conquer red alert 3: premier edition - pc,2,2,1,1,1,7,2.5714285714285716
mystery case files 8:  escape from ravenhurst - pc,0,0,0,1,6,7,4.857142857142857
five nights at freddy's [download],1,0,2,1,3,7,3.7142857142857144
monster hunter 4 3ds ll pouch (emblem),0,0,1,1,5,7,4.571428571428571
empire earth gold - pc,0,0,2,2,3,7,4.142857142857143
metropolis street racer,1,0,0,2,4,7,4.142857142857143
watch dogs 2: deluxe edition (includes extra content) - playstation 4,0,0,1,1,5,7,4.571428571428571
titanic - nintendo ds,1,2,2,1,1,7,2.857142857142857
nhl 09 - playstation 3,2,0,0,0,5,7,3.857142857142857
new arrival ps4 cooling fan cooler fan for ps4 playstation4 console host + charging cable,0,0,0,2,5,7,4.714285714285714
minecraft - xbox one digital code,0,0,0,3,4,7,4.571428571428571
mech warrior 4: mercenaries - pc,0,0,1,2,4,7,4.428571428571429
watch dogs 2: gold edition (includes extra content + season pass subscription) - playstation 4,0,0,1,1,5,7,4.571428571428571
dragon ball: raging blast - xbox 360,0,0,3,1,3,7,4.0
mx vs. atv: supercross encore edition - playstation 4,1,0,1,1,4,7,4.0
"skylanders giants triple pack #2 ignitor, chill, and zook",0,0,0,1,6,7,4.857142857142857
playstation 3 glow vertical stand,0,0,0,3,4,7,4.571428571428571
need for speed carbon: own the city greatest hits -sony psp,0,0,2,2,3,7,4.142857142857143
conflict global terror - xbox,1,0,1,1,4,7,4.0
gothic 3 collector's edition - pc,2,0,1,2,2,7,3.2857142857142856
xbox 360 s video av cable,0,0,1,1,5,7,4.571428571428571
personal trainer walking,0,0,2,1,4,7,4.285714285714286
the witness - ps4 [digital code],0,1,1,2,3,7,4.0
spyro shadow legacy - nintendo ds,0,0,1,2,4,7,4.428571428571429
shadow dancer: the secret of shinobi,0,1,1,0,5,7,4.285714285714286
jane's hotel - nintendo ds,0,0,1,2,4,7,4.428571428571429
"rocksmith 2014 edition - ""no cable included"" version for rocksmith owners - playstation 3",0,0,1,2,4,7,4.428571428571429
nintendo wii/wii u remote plus controller - toad (japanese version),0,0,0,0,7,7,5.0
world of warcraft battle chest - (obsolete),0,0,1,1,5,7,4.571428571428571
vexx,0,0,0,4,3,7,4.428571428571429
call of duty: modern warfare: mobilized - nintendo ds,4,0,0,0,3,7,2.7142857142857144
mickey's speedway usa,0,0,1,2,4,7,4.428571428571429
mega man 64,1,0,0,3,3,7,4.0
sea of thieves: standard edition - xbox one digital code,0,0,2,3,2,7,4.0
wild arms 4 - playstation 2,0,2,1,2,2,7,3.5714285714285716
wcw vs. nwo world tour,0,0,1,1,5,7,4.571428571428571
don't starve [online game code],1,0,0,3,3,7,4.0
ear force x1 stereo headset with chat - xbox 360,0,0,1,3,3,7,4.285714285714286
forbidden secrets: alien town [download],0,0,1,3,3,7,4.285714285714286
pitfall!,0,0,0,1,6,7,4.857142857142857
game boy advance - fuchsia,0,1,0,1,5,7,4.428571428571429
cel damage for xbox,0,1,1,2,3,7,4.0
stealth 350vr amplified virtual reality gaming headset - variable bass boost - mic monitoring - playstation vr and ps4 - playstation 4,0,0,0,5,2,7,4.285714285714286
castlevania double pack: aria of sorrow / harmony of dissonance,0,0,1,1,5,7,4.571428571428571
galgun: double peace - playstation vita,0,0,0,2,5,7,4.714285714285714
game boy micro ac wall charger micro power adapter,1,0,0,2,4,7,4.142857142857143
dragonball z budokai tenkaichi 2,0,0,0,1,6,7,4.857142857142857
breath of fire iii - sony psp,0,1,0,1,5,7,4.428571428571429
crusader kings ii [download],2,0,1,1,3,7,3.4285714285714284
"gem box – video game console – for family gaming, kids gaming and serious gamers",2,2,2,1,0,7,2.2857142857142856
plantronics rig stereo gaming headset with mixer for xbox 360 and ps3 - retail packaging - black,0,0,0,2,5,7,4.714285714285714
mlb 06 the show - playstation 2,1,1,2,2,1,7,3.142857142857143
vampire rain: altered species - playstation 3,0,2,4,1,0,7,2.857142857142857
assassin's creed iv black flag,0,0,3,0,4,7,4.142857142857143
spider-man: mysterio's menace,0,1,0,2,4,7,4.285714285714286
"insten eva case compatible with nintendo new 3ds xl / new 2ds xl / 3ds xl / 3ds ll, black",0,1,0,0,6,7,4.571428571428571
kya: dark lineage,0,0,1,3,3,7,4.285714285714286
king of fighters collection: the orochi saga - nintendo wii,0,0,0,3,4,7,4.571428571428571
final fantasy xi ultimate collection seekers edition [download],2,1,1,0,3,7,3.142857142857143
guitar hero aerosmith wireless bundle -xbox 360,0,2,2,2,1,7,3.2857142857142856
tom clancy's splinter cell essentials - sony psp,0,1,1,2,3,7,4.0
halo reach wireless xbox 360 controller,0,0,0,1,6,7,4.857142857142857
zombie army trilogy - xbox one,0,0,0,2,5,7,4.714285714285714
baldur's gate 2 expansion: throne of bhaal - pc,0,0,0,2,5,7,4.714285714285714
ds lite battery,0,0,1,4,2,7,4.142857142857143
mlb 2k13 - playstation 3,0,0,1,2,4,7,4.428571428571429
the legend of heroes: a tear of vermillion - sony psp,0,1,0,2,4,7,4.285714285714286
tom clancy's ghost recon trilogy edition,0,0,2,1,4,7,4.285714285714286
vacation quest: australia - pc,0,0,0,0,7,7,5.0
bakugan battle brawlers nds,1,0,1,0,5,7,4.142857142857143
pink yarn yoshi amiibo - japan import (yoshi's woolly world series),0,0,0,0,7,7,5.0
x-men: mutant academy 2,0,0,1,0,6,7,4.714285714285714
superman the man of steel,0,1,3,1,2,7,3.5714285714285716
sherlock holmes:  nemesis - pc,0,0,0,4,3,7,4.428571428571429
3 pack game boy game case - game boy advance,1,0,1,2,3,7,3.857142857142857
fallout tactics,0,0,0,3,4,7,4.571428571428571
pdp master sword stylus display,0,0,0,1,6,7,4.857142857142857
monster hunter 4 ultimate standard edition with felyne pin - nintendo 3ds,0,0,0,1,6,7,4.857142857142857
nintendo pokémon x & y limited edition 3 ds xl (red),1,0,1,1,4,7,4.0
gladius - gamecube,1,0,0,1,5,7,4.285714285714286
dying light [online game code],0,0,2,2,3,7,4.142857142857143
tenchu: return from darkness,0,1,0,3,3,7,4.142857142857143
peggle dual shot - nintendo ds,0,0,1,1,5,7,4.571428571428571
toejam & earl - sega genesis,0,0,0,0,7,7,5.0
microsoft xbox 360 game system hdmi console 60gb,1,0,0,1,5,7,4.285714285714286
the sims 3 - nintendo ds,3,0,2,0,2,7,2.7142857142857144
playstation gold wireless headset - uncharted 4 limited edition,1,0,0,1,5,7,4.285714285714286
monopoly streets - nintendo wii,0,0,2,1,4,7,4.285714285714286
x2: wolverine's revenge (xbox),1,0,1,2,3,7,3.857142857142857
skylanders giants: single character pack core series 2 stump smash,0,0,0,1,6,7,4.857142857142857
majin and the forsaken kingdom - playstation 3,1,0,2,2,2,7,3.5714285714285716
fifa soccer 10 - xbox 360,0,1,0,0,6,7,4.571428571428571
dark strokes: sins of the fathers [download],0,0,0,3,4,7,4.571428571428571
destroy all humans 2,0,0,1,0,6,7,4.714285714285714
test drive le mans,0,0,0,2,5,7,4.714285714285714
wii bowling ball,0,2,1,1,3,7,3.7142857142857144
project igi: i'm going in - pc,1,0,3,2,1,7,3.2857142857142856
batman begins - xbox,0,0,1,2,4,7,4.428571428571429
code: realize guardian of rebirth - playstation vita,0,0,0,1,6,7,4.857142857142857
james bond 007: quantum of solace - playstation 2,0,0,0,4,3,7,4.428571428571429
battlefield 1 - pc [no disc],3,0,1,1,2,7,2.857142857142857
lux pain - nintendo ds,1,0,2,1,3,7,3.7142857142857144
mega man zero 2,0,1,1,3,2,7,3.857142857142857
command & conquer: red alert 3 - xbox 360,2,1,0,2,2,7,3.142857142857143
actraiser - nintendo super nes,0,0,0,2,5,7,4.714285714285714
the sky crawlers: innocent aces - nintendo wii,0,0,2,1,4,7,4.285714285714286
borderlands 2 deluxe vault hunter's edition -xbox 360,0,0,0,1,6,7,4.857142857142857
ride - playstation 4,2,0,1,2,2,7,3.2857142857142856
ferrari challenge - playstation 3,2,1,1,2,1,7,2.857142857142857
lego dimensions starter pack - playstation 3,0,0,0,1,6,7,4.857142857142857
excitebike 64,0,0,2,1,4,7,4.285714285714286
pro evolution soccer 2013 - nintendo wii,0,0,1,0,6,7,4.714285714285714
big kahuna reef 2 [download],0,0,2,0,5,7,4.428571428571429
the sims 3 starter pack [online game code],1,0,0,1,5,7,4.285714285714286
wheel of fortune - xbox 360,0,0,0,2,5,7,4.714285714285714
deus ex: the conspiracy,1,0,0,2,4,7,4.142857142857143
phantasy star universe - xbox 360,0,0,3,2,2,7,3.857142857142857
grand theft auto: san andreas v2.0 - pc,1,1,0,1,4,7,3.857142857142857
knockout kings 2001,0,0,0,3,4,7,4.571428571428571
grim fandango - pc,0,0,0,0,7,7,5.0
wwe smackdown vs. raw 2007,1,1,0,2,3,7,3.7142857142857144
nascar heat evolution (xbox one) - xbox one,2,1,1,0,3,7,3.142857142857143
ssx on tour - playstation 2,0,0,1,3,3,7,4.285714285714286
disgaea ds,1,0,1,1,4,7,4.0
dokapon kingdom - nintendo wii,2,2,0,2,1,7,2.7142857142857144
roller coaster tycoon expansion pack:  loopy landscapes - pc,0,0,1,2,4,7,4.428571428571429
ape escape on the loose psp,1,0,0,2,4,7,4.142857142857143
unreal tournament,0,0,0,2,5,7,4.714285714285714
rock band 2 - playstation 2 (game only),0,0,0,1,6,7,4.857142857142857
call of duty: black ops iii - standard edition - playstation 4 [digital code],1,0,0,1,5,7,4.285714285714286
nyko modular charge station - 2 port controller charging station with 2 rechargeable battery packs for xbox one,0,1,2,1,3,7,3.857142857142857
yoshi topsy-turvy,0,0,1,1,5,7,4.571428571428571
kung fu chaos,1,2,0,0,4,7,3.5714285714285716
teen titans - gamecube,0,0,0,1,6,7,4.857142857142857
tom clancy's rainbow six rogue spear - pc,0,0,0,1,6,7,4.857142857142857
peggle - pc,0,0,0,1,6,7,4.857142857142857
orphen - playstation 2,2,2,1,1,1,7,2.5714285714285716
diablo ii: lord of destruction expansion set,0,0,0,0,7,7,5.0
chronicles of mystery: curse of the ancient temple - nintendo ds,0,0,2,3,2,7,4.0
playstation nwtwork card,2,0,0,0,5,7,3.857142857142857
hori fighting commander for playstation 4 & 3 officially licensed by sony - playstation 4,1,1,2,1,2,7,3.2857142857142856
dark - xbox 360,3,0,3,0,1,7,2.4285714285714284
nintendo 3ds xl - blue/black with mario kart 7 pre-installed,0,0,0,1,6,7,4.857142857142857
mizar replacement xbox power cable 1st generation xbox (not compatible xbox 360 or one),0,0,0,1,6,7,4.857142857142857
pac-man and the ghostly adventures - nintendo 3ds,0,0,2,2,3,7,4.142857142857143
the price is right,0,1,4,0,2,7,3.4285714285714284
skylanders giants: single character pack core series 2 trigger happy,0,0,0,0,7,7,5.0
stronghold 2 - pc,1,0,1,3,2,7,3.7142857142857144
madden nfl 17 - standard edition - playstation 3,0,1,0,2,4,7,4.285714285714286
need for speed: undercover,0,1,0,3,3,7,4.142857142857143
turtle beach call of duty advanced warfare ear force sentinel task force gaming headset for xbox one (discontinued by manufacturer),0,1,0,4,2,7,4.0
the sims 3 supernatural [download],1,0,0,2,4,7,4.142857142857143
unreal tournament: game of the year edition - pc,0,0,0,0,7,7,5.0
wolfenstein: the old blood [online game code],0,0,2,2,3,7,4.142857142857143
rock candy ps3 controller - blue,0,0,3,2,2,7,3.857142857142857
sega genesis 6-pak,0,0,0,0,7,7,5.0
harry potter and the half blood prince - playstation 3,0,0,0,3,4,7,4.571428571428571
damage pacific squadron wwii for xbox 360 - collectors edition,0,0,1,1,5,7,4.571428571428571
planetside 2 [download],1,1,1,0,4,7,3.7142857142857144
land of the dead - xbox,2,1,1,0,3,7,3.142857142857143
contact - nintendo ds,0,0,3,3,1,7,3.7142857142857144
"foamy lizard wii u dust cover set the original made in u.s.a. texoshield (tm) premium soft lined leatherette dust guard & gamepad pouch w/back cable port (horizontal, black)",0,0,0,0,7,7,5.0
lvl99gear playstation 4 console vertical stand,0,2,1,1,3,7,3.7142857142857144
electronic arts 36866 battlefield 1 (ciab) pc,1,0,0,1,5,7,4.285714285714286
ubisoft monopoly family fun pack | xbox one standard edition,0,2,1,1,3,7,3.7142857142857144
aweek® usb hub adapter 4 usb ports for xbox one x-box one black,1,0,1,1,4,7,4.0
giants: citizen kabuto - pc,0,1,1,3,2,7,3.857142857142857
guitar hero world tour band bundle for playstation 3,1,0,1,1,4,7,4.0
wheel of fortune - nintendo wii u,0,1,2,0,4,7,4.0
star wars the clone wars: republic heroes - xbox 360,1,1,1,4,0,7,3.142857142857143
warriors orochi 3 - xbox 360,0,0,0,1,6,7,4.857142857142857
thrustmaster   t300rs officially licensed ps4/ps3 force feedback racing wheel,0,0,1,0,6,7,4.714285714285714
lego star wars iii: the clone wars - nintendo ds,0,0,0,2,5,7,4.714285714285714
viva pinata: pocket paradise - nintendo ds,0,0,0,1,6,7,4.857142857142857
tony hawk's project 8 - playstation 3,0,0,1,2,4,7,4.428571428571429
star wars: the old republic – knights of the eternal throne – amazon premium pack [online game code],0,0,1,0,6,7,4.714285714285714
emperor: battle for dune - pc,0,0,2,1,4,7,4.285714285714286
repairbox replacement joystick for n64,0,0,1,1,5,7,4.571428571428571
f1 2016 - xbox one,0,0,0,1,6,7,4.857142857142857
starcraft 64,0,0,1,0,6,7,4.714285714285714
atari flashback classics: volume 2,1,0,0,3,3,7,4.0
hasbro family game night - nintendo wii,0,0,1,2,4,7,4.428571428571429
hde 5-port usb expansion hub for sony playstation 3 consoles compatible with original ps3 (fat) and slim models,0,0,0,0,7,7,5.0
borderlands 2 psycho pack [download],0,1,2,1,3,7,3.857142857142857
astro gaming a50 ps4 - black (2014 model),1,0,2,1,3,7,3.7142857142857144
tomee nes usb controller for pc/mac,2,0,1,0,4,7,3.5714285714285716
metal slug 7 - nintendo ds,0,0,0,2,5,7,4.714285714285714
fallout 4: automatron - ps4 [digital code],2,0,2,3,0,7,2.857142857142857
dead rising 2 - pc,3,0,1,1,2,7,2.857142857142857
tom clancy's rainbow six siege - gold edition - xbox one,2,0,0,1,4,7,3.7142857142857144
simanimals - nintendo wii,0,1,3,1,2,7,3.5714285714285716
ggg0021 grey xbox 360 replacement thumbsticks (4 pack) plus torx t8 security screwdriver l key replace your controller joystick,0,1,1,1,4,7,4.142857142857143
star wars the clone wars: republic heroes - playstation 3,1,2,1,0,3,7,3.2857142857142856
star wars galaxies: the complete online adventures - pc,4,1,1,0,1,7,2.0
tetris ultimate - playstation vita,0,0,0,0,7,7,5.0
star wars: masters of teras kasi,1,1,0,1,4,7,3.857142857142857
just dance 2014,0,0,1,2,4,7,4.428571428571429
simcity 3000 - pc,1,1,1,2,2,7,3.4285714285714284
star wars: dark forces (jewel case) - pc,0,0,1,2,4,7,4.428571428571429
final fight 3,0,0,2,2,3,7,4.142857142857143
charge base pro for wii u,0,0,0,0,7,7,5.0
pinball hall of fame the gottlieb collection - sony psp,0,0,2,1,4,7,4.285714285714286
nba 2k17 - legends gold - playstation 4,1,0,2,0,4,7,3.857142857142857
"final fantasy xi: chains of promathia, rise of the zilart, treasures of aht urhgan - xbox 360",0,3,0,2,2,7,3.4285714285714284
soldier of fortune gold edition - pc,2,0,0,1,4,7,3.7142857142857144
burnout paradise: the ultimate box - pc,3,0,0,2,2,7,3.0
disney infinity wreck-it ralph,0,0,0,0,7,7,5.0
playstation 3 onechanbara z kagura with nonono!,0,0,1,3,3,7,4.285714285714286
tears to tiara ii: heir of the overlord - playstation 3,2,0,0,3,2,7,3.4285714285714284
".hack: g.u., vol. 1: rebirth",1,1,0,4,1,7,3.4285714285714284
tom clancy's rainbow six siege - gold edition - playstation 4,1,1,0,1,4,7,3.857142857142857
nancy drew: tomb of the lost queen,0,0,2,3,2,7,4.0
naruto clash of ninja 2 - gamecube,0,0,1,3,3,7,4.285714285714286
dead island riptide,1,2,0,2,2,7,3.2857142857142856
battletanx,1,0,1,1,4,7,4.0
star trek tactical assault - nintendo ds,0,1,4,0,2,7,3.4285714285714284
street fighter iv - pc,0,1,0,3,3,7,4.142857142857143
polk audio 4shot headphone - blue - xbox one,3,0,1,1,2,7,2.857142857142857
gradius iii - nintendo super nes,0,0,2,1,4,7,4.285714285714286
despicable me: the game for wii,0,0,2,0,5,7,4.428571428571429
the castlevania adventure,2,2,1,0,2,7,2.7142857142857144
the curse of monkey island,0,0,0,1,6,7,4.857142857142857
"nintendo wii console, white rvl-101 (newest model)",3,0,0,1,3,7,3.142857142857143
xbox 360 multi-reader,1,0,0,2,4,7,4.142857142857143
nba 2k17 - legend edition - playstation 4,1,0,1,1,4,7,4.0
cradle of rome 2 - nintendo 3ds,0,0,0,1,6,7,4.857142857142857
avatar the game - nintendo wii,0,1,1,1,4,7,4.142857142857143
spongebob squarepants: plankton's robotic revenge - nintendo wii u,0,0,1,1,5,7,4.571428571428571
xbox one s vertical stand,0,0,0,3,4,7,4.571428571428571
heavy fire: shattered spear - xbox 360,3,0,0,0,4,7,3.2857142857142856
resident evil 5 collector's edition -xbox 360,0,1,1,3,2,7,3.857142857142857
tony hawk's project 8 - xbox 360,1,2,2,1,1,7,2.857142857142857
"skylanders trap team: air, undead, & fire trap - triple trap pack",0,0,0,0,7,7,5.0
grid 2 - xbox 360,0,2,1,3,1,7,3.4285714285714284
pspgo cradle,0,0,2,1,4,7,4.285714285714286
third party made xbox 360 wireless gaming receiver black,0,0,0,2,5,7,4.714285714285714
chaser - pc,1,0,2,2,2,7,3.5714285714285716
nyko playpad wireless game controller for android tablets and smart phones,2,2,1,0,2,7,2.7142857142857144
the secret files: tunguska - pc,0,0,4,0,3,7,3.857142857142857
game shark,2,2,1,1,1,7,2.5714285714285716
namcos museum vol. 3,0,0,0,4,3,7,4.428571428571429
scarface: the world is yours - xbox,0,0,2,2,3,7,4.142857142857143
atv offroad fury 4 - playstation 2,1,0,0,0,6,7,4.428571428571429
ultimate i spy - nintendo wii,0,0,0,1,6,7,4.857142857142857
ultra street fighter iv - xbox 360,0,0,0,3,4,7,4.571428571428571
still life - pc,1,0,1,4,1,7,3.5714285714285716
call of duty modern warfare 2 platinum hits - xbox 360,0,0,0,0,7,7,5.0
escape dead island - xbox 360,0,1,0,4,2,7,4.0
super monkey ball banana splitz - playstation vita,0,1,1,3,2,7,3.857142857142857
the bigs 2 - nintendo wii,0,2,1,1,3,7,3.7142857142857144
diablo iii - pc/mac [digital code] [online game code],1,0,1,0,5,7,4.142857142857143
the sims 2: castaway - playstation 2,0,0,1,2,4,7,4.428571428571429
headphone audio adapter for xbox 360,1,0,0,2,4,7,4.142857142857143
trenro wired controller usb breakaway cable cord,0,0,0,1,6,7,4.857142857142857
monopoly collection - nintendo wii,0,0,0,0,7,7,5.0
wild arms alter code f - playstation 2,0,1,1,2,3,7,4.0
starcraft expansion pack: brood war - pc,0,0,1,0,6,7,4.714285714285714
heavy rain,0,0,0,1,6,7,4.857142857142857
kung fu high impact - xbox 360,0,0,0,3,4,7,4.571428571428571
ferrari universal 5-in-1 challenge wheel,0,0,0,4,3,7,4.428571428571429
third party made blue wired usb game pad controller for xbox 360,5,0,0,1,1,7,2.0
bionic commando - nintendo nes,0,0,0,0,7,7,5.0
the adventures of bayou billy,0,1,3,0,3,7,3.7142857142857144
simcity 2000 special edition (jewel case) - pc,0,0,1,0,6,7,4.714285714285714
dreamgear 3-piece stylus pack for nintendo 3ds,0,1,2,1,3,7,3.857142857142857
disney infinity 3.0 edition: nick wilde figure,1,0,0,0,6,7,4.428571428571429
csi: hard evidence - xbox 360,1,0,4,1,1,7,3.142857142857143
dreamgear nintendo 3ds 20-in-1 essentials kit (black),0,0,1,2,4,7,4.428571428571429
thor: god of thunder - nintendo ds,0,0,0,1,6,7,4.857142857142857
skylanders spyro's adventure: chop chop,0,0,0,2,5,7,4.714285714285714
final fantasy adventure,0,0,0,2,5,7,4.714285714285714
amazonbasics controller charge hub for ps3 (officially licensed by sony),0,2,5,0,0,7,2.7142857142857144
hulk - xbox,0,1,3,0,3,7,3.7142857142857144
prince of persia: warrior within - pc,0,1,0,2,4,7,4.285714285714286
burnout 2: point of impact,1,0,0,3,3,7,4.0
hde usb ac power supply cable adapter for xbox microsoft 360 kinect motion sensor,0,0,0,2,5,7,4.714285714285714
sanitarium - pc,0,0,1,3,3,7,4.285714285714286
midnight club 3 (dub edition) - playstation 2,0,1,0,0,6,7,4.571428571428571
parappa the rapper 2,2,1,3,1,0,7,2.4285714285714284
pirates of the burning sea - pc,0,1,4,2,0,7,3.142857142857143
microsoft combat flight simulator: wwii europe series - pc,0,0,4,0,3,7,3.857142857142857
jackal - nintendo nes,0,0,1,2,4,7,4.428571428571429
monster hunter freedom 2 - sony psp,0,0,1,0,6,7,4.714285714285714
disney infinity 3.0 edition: star wars rebels ezra bridger figure,0,0,0,0,7,7,5.0
playstation thumb grips (for ps4 and ps3 controllers),0,0,0,1,6,7,4.857142857142857
tiger woods pga tour 2006 - xbox 360,1,2,0,3,1,7,3.142857142857143
mega man x command mission - gamecube,0,1,1,0,5,7,4.285714285714286
metal gear solid: vr missions,0,0,0,5,2,7,4.285714285714286
nintendo amiibo chibi-robo (japanese import),0,0,0,1,6,7,4.857142857142857
armored core v - xbox 360,1,1,1,1,3,7,3.5714285714285716
raw danger - playstation 2,0,1,2,2,2,7,3.7142857142857144
romance of the three kingdoms vii,1,0,1,3,2,7,3.7142857142857144
neverwinter nights platinum - pc,0,0,0,3,4,7,4.571428571428571
double dribble - nintendo nes,1,0,3,0,3,7,3.5714285714285716
leisure suit larry: magna cum laude - playstation 2,2,0,1,0,4,7,3.5714285714285716
kontrolfreek fps freek galaxy purple performance thumbsticks for playstation 4 controller (ps4),0,0,2,0,5,7,4.428571428571429
middle earth: shadow of mordor [online game code],0,0,0,5,2,7,4.285714285714286
half-life 2: collector's edition - pc,2,0,1,2,2,7,3.2857142857142856
shell shock: nam 67 - xbox,1,0,2,2,2,7,3.5714285714285716
sega dreamcast green visual memory unit vmu,0,0,0,0,7,7,5.0
ncaa football 08 - playstation 3,1,1,1,2,2,7,3.4285714285714284
nhl 15 - playstation 3,2,0,1,0,4,7,3.5714285714285716
disney infinity 3.0 edition: star wars™ saga bundle - ps3,0,0,0,1,6,7,4.857142857142857
madden nfl 08 - playstation 3,1,0,2,1,3,7,3.7142857142857144
scooby doo: night of 100 frights,1,0,0,1,5,7,4.285714285714286
the bard's tale - pc,0,0,3,1,3,7,4.0
country dance wii,1,0,0,3,3,7,4.0
nyko charge base - 2 port controller charger with 2 usb charge adapters for playstation 3,2,0,0,1,4,7,3.7142857142857144
chessmaster - xbox,0,2,1,1,3,7,3.7142857142857144
wolfenstein 3d (jewel case) - pc,0,0,0,0,7,7,5.0
payday 2 crimewave - playstation 4,1,0,2,2,2,7,3.5714285714285716
15ft ps4 controller charging cable for playstation 4 dual shock 4,1,1,1,2,2,7,3.4285714285714284
wii u super smash bros and splatoon bundle - special edition deluxe set,0,0,1,2,4,7,4.428571428571429
sniper elite iii ultimate edition - playstation 3,0,0,0,2,5,7,4.714285714285714
star wars: rebellion - pc,0,0,1,4,2,7,4.142857142857143
fight night 2004,0,0,1,5,1,7,4.0
".hack: g.u., vol. 2 - reminisce",0,0,1,2,4,7,4.428571428571429
no man's sky -  ps4 [digital code],2,2,1,1,1,7,2.5714285714285716
the black eyed peas experience - nintendo wii,0,0,1,1,5,7,4.571428571428571
indiana jones and the emperor's tomb,0,1,1,2,3,7,4.0
horipad fps plus,0,0,0,2,5,7,4.714285714285714
zero time dilemma vita,0,0,1,1,5,7,4.571428571428571
stick it to the man ps4 - playstation 4,1,0,0,0,6,7,4.428571428571429
medievil resurrection - sony psp,0,0,1,0,6,7,4.714285714285714
deepak chopra's leela - xbox 360,1,1,1,3,1,7,3.2857142857142856
test drive unlimited 2 [download],0,2,1,0,4,7,3.857142857142857
medieval ii total war: kingdoms expansion pack - pc,1,0,1,2,3,7,3.857142857142857
playstation 4 500gb console  - the last of us remastered bundle,0,0,0,1,6,7,4.857142857142857
ghost hunter,0,0,1,5,1,7,4.0
firepro wrestling - game boy advance,0,1,1,1,4,7,4.142857142857143
dungeons & dragons online: stormreach - pc (standard (dvd)),0,1,2,4,0,7,3.4285714285714284
titanfall [instant access],0,0,1,2,4,7,4.428571428571429
rise of nations gold - pc,0,1,2,0,4,7,4.0
deception iv: blood ties - playstation vita,0,0,0,3,4,7,4.571428571428571
deception iv: blood ties - playstation 3,0,0,2,3,2,7,4.0
star trek deep space nine:  the fallen - pc,0,0,0,5,2,7,4.285714285714286
everybody's gone to the rapture - ps4 [digital code],2,3,1,0,1,7,2.2857142857142856
snoopy's grand adventure - xbox 360,0,1,2,2,2,7,3.7142857142857144
starter kit - black for 3ds,1,0,1,1,4,7,4.0
mtv's beavis and butthead,1,0,1,2,3,7,3.857142857142857
universe at war: earth assault - xbox 360,0,0,3,2,2,7,3.857142857142857
aliens versus predator 2 expansion: primal hunt - pc,0,0,4,2,1,7,3.5714285714285716
wild arms 5 - playstation 2,0,0,3,2,2,7,3.857142857142857
mortal kombat: kollector's edition - playstation 3,0,0,0,0,7,7,5.0
super mario bros. 3 - 3ds [digital code],0,0,0,1,6,7,4.857142857142857
fast & furious: showdown - xbox 360,2,0,0,1,4,7,3.7142857142857144
star trek [online game code],2,0,0,3,2,7,3.4285714285714284
astro gaming a40 tr headset + mixamp pro tr for xbox one,0,0,0,1,6,7,4.857142857142857
kinect sports rivals - xbox one,1,0,1,0,5,7,4.142857142857143
rayman origins - with artbook - playstation 3 (standard with amazon exclusive art book),0,0,1,1,5,7,4.571428571428571
pro wrestling,0,0,1,3,3,7,4.285714285714286
resistance 3 doomsday edition - playstation 3,0,0,2,0,5,7,4.428571428571429
the hobbit,0,0,1,3,3,7,4.285714285714286
rabbids go home,1,0,1,0,5,7,4.142857142857143
the lost crown: a ghosthunting adventure - pc,0,0,1,1,5,7,4.571428571428571
rush 'n attack,0,0,3,2,2,7,3.857142857142857
yu-gi-oh! the eternal duelist soul,0,0,0,3,4,7,4.571428571428571
doom: collector's edition,0,0,0,0,7,7,5.0
sherlock holmes vs. jack the ripper - pc,0,0,1,1,5,7,4.571428571428571
arc the lad: collection,0,0,1,3,3,7,4.285714285714286
the elder scrolls online [online game code],2,2,1,0,2,7,2.7142857142857144
disney infinity 3.0 edition: toy box speedway (a toy box expansion game),0,1,1,0,5,7,4.285714285714286
blue stinger,1,0,0,3,3,7,4.0
battlestar galactica - playstation 2,0,1,2,1,3,7,3.857142857142857
tony hawk's underground 2,0,0,2,3,2,7,4.0
goldeneye rogue agent,1,1,2,0,3,7,3.4285714285714284
nba 2k8 - playstation 3,0,0,1,1,5,7,4.571428571428571
playstation 2 dance mat,3,0,2,2,0,7,2.4285714285714284
shadowgate - nintendo nes,0,0,0,3,4,7,4.571428571428571
river city: tokyo rumble with free limited edition kunio keychain,0,0,0,2,5,7,4.714285714285714
game boy advance - limited edition platinum,0,0,0,2,5,7,4.714285714285714
dragon quest monsters: joker 2 - nintendo ds,0,0,1,1,5,7,4.571428571428571
rock band: special edition,0,0,0,5,2,7,4.285714285714286
digimon world 3,0,0,0,1,6,7,4.857142857142857
sing party with wii u microphone,1,0,2,2,2,7,3.5714285714285716
donkey kong: barrel blast - nintendo wii,0,0,1,2,4,7,4.428571428571429
rock band 4 bundle with legacy game controller adapter - xbox one,2,1,1,2,1,7,2.857142857142857
scooby-doo: night of 100 frights - playstation 2,0,0,0,3,4,7,4.571428571428571
g.h.o.s.t. hunters - the haunting of majesty manor,0,0,1,2,4,7,4.428571428571429
"skylanders spyro's adventure triple character pack (zap, hex, dino rang)",0,0,0,2,5,7,4.714285714285714
2x replacement analog stick thumbsticks with t6 tools for sony dual shock 4 ps4 controller,1,0,0,1,5,7,4.285714285714286
back to the future: the game - 30th anniversary - xbox 360,0,0,1,1,5,7,4.571428571428571
gauntlet,1,0,0,0,6,7,4.428571428571429
headhunter (playstation 2),0,0,1,5,1,7,4.0
warcraft iii: reign of chaos collector's edition - pc/mac,0,1,0,1,5,7,4.428571428571429
power rangers dino thunder - playstation 2,2,0,0,1,4,7,3.7142857142857144
skate or die - nintendo nes,0,1,1,1,4,7,4.142857142857143
mario party advance,0,0,1,4,2,7,4.142857142857143
risen 3: titan lords - xbox 360,0,2,2,1,2,7,3.4285714285714284
crash bandicoot wrath of cortex - xbox,0,0,1,4,2,7,4.142857142857143
disney infinity 3.0: rise against the empire bundle - amazon exclusive,0,0,0,0,7,7,5.0
fallout brotherhood of steel - xbox,0,0,2,3,2,7,4.0
extension cable for nintendo 64 n64 controller,0,0,0,0,7,7,5.0
spider-man: the edge of time - playstation 3,0,0,0,3,4,7,4.571428571428571
proimb vertical stand with cooling fan for playstation 4 ps4,1,0,2,0,4,7,3.857142857142857
street fighter alpha 3,0,1,2,3,1,7,3.5714285714285716
spider-man: the edge of time - nintendo 3ds,0,0,1,2,4,7,4.428571428571429
warhammer dawn of war platinum - pc,0,1,0,4,2,7,4.0
cut the rope: triple treat - nintendo 3ds,0,0,0,0,7,7,5.0
black hard case for sony psp 3000,0,1,0,0,6,7,4.571428571428571
infamous second son - ps4 [digital code],0,0,0,2,5,7,4.714285714285714
capcom classics collection - xbox,0,0,2,1,4,7,4.285714285714286
espn nba 2k5 - playstation 2,1,0,0,3,3,7,4.0
soldier of fortune payback - playstation 3,0,1,0,4,2,7,4.0
nba 2k11 [download],0,0,1,3,3,7,4.285714285714286
thrustmaster y-350x 7.1 powered doom edition for xbox one and windows,0,0,2,3,2,7,4.0
sid meier's pirates!,0,1,1,4,1,7,3.7142857142857144
psp headphones with remote control,1,0,1,1,4,7,4.0
ty the tasmanian tiger 2: bush rescue - playstation 2,0,1,1,1,4,7,4.142857142857143
xbox 360 wireless racing wheel,0,0,2,2,3,7,4.142857142857143
3 pack clear lcd screen protector cover for nintendo 3ds (set of 2 - top and bottom cover),1,0,1,2,3,7,3.857142857142857
insassy ac adapter power supply brick for xbox 360 slim - auto voltage 100-240v 2a 47-63hz,0,0,0,3,4,7,4.571428571428571
skylanders swap force nitro magna charge,0,0,0,0,7,7,5.0
big rigs: over the road racing,4,0,0,0,3,7,2.7142857142857144
skylanders superchargers: vehicle shield striker character pack,0,0,0,1,6,7,4.857142857142857
skylanders superchargers: drivers nightfall character pack,0,0,0,0,7,7,5.0
skylanders superchargers: drivers fiesta character pack,0,0,0,0,7,7,5.0
lumines ii - sony psp,0,0,1,4,2,7,4.142857142857143
far cry 4 complete edition - playstation 4,0,0,0,4,3,7,4.428571428571429
metal arms: glitch in the system,0,0,0,2,5,7,4.714285714285714
spyro: attack of the rhynocs,1,0,2,1,3,7,3.7142857142857144
outrun 2 - xbox,0,0,2,1,4,7,4.285714285714286
digimon rumble arena,0,0,0,0,7,7,5.0
age of empires: the age of kings,0,1,1,0,5,7,4.285714285714286
ps3 controller rechargeable battery pack,0,1,0,0,6,7,4.571428571428571
looney toons: acme arsenal - nintendo wii,3,0,1,0,3,7,3.0
rock band 4 - legacy game controller adapter for xbox one,1,0,2,1,3,7,3.7142857142857144
harvest moon: tale of two towns - nintendo ds,1,0,0,1,5,7,4.285714285714286
3 in 1 magic joy box (ps2/ps/gc/xbox to pc usb adapter),1,1,1,2,2,7,3.4285714285714284
nhl 2006 - playstation 2,0,1,1,3,2,7,3.857142857142857
metal gear solid portable ops plus,0,1,0,1,5,7,4.428571428571429
company of heroes 2 - pc,1,0,1,3,2,7,3.7142857142857144
kontrolfreek fps freek vortex performance thumbsticks for xbox one controller,0,0,3,1,3,7,4.0
the godfather (dvd-rom) - pc,0,0,4,2,1,7,3.5714285714285716
elder scrolls v: skyrim collector's edition - pc,0,0,0,2,5,7,4.714285714285714
fifa 08 - playstation 3,0,0,0,1,6,7,4.857142857142857
naruto ultimate ninja 2 - playstation 2,0,0,0,0,7,7,5.0
baldur's gate original saga with tales of the sword coast expansion pack - pc,0,0,0,1,6,7,4.857142857142857
doom 3 bfg edition [online game code],2,0,0,1,4,7,3.7142857142857144
pokemon colosseum bonus disc,0,0,0,0,7,7,5.0
"hey you, pikachu!",1,0,2,3,1,7,3.4285714285714284
my word coach,0,0,2,1,4,7,4.285714285714286
wings over vietnam - pc,0,2,1,1,3,7,3.7142857142857144
classic adventures: the great gatsby [download],0,0,1,1,5,7,4.571428571428571
pangya: fantasy golf - sony psp,0,0,1,4,2,7,4.142857142857143
the amazing spider-man - nintendo 3ds,0,0,0,1,6,7,4.857142857142857
far cry 3 deluxe edition [online game code],0,1,0,2,4,7,4.285714285714286
2 singstar pop rocks amped 90s 80s microphones ps2 ps3,0,0,0,2,5,7,4.714285714285714
reload,1,0,1,1,4,7,4.0
lbx: little battlers experience - nintendo 3ds standard edition,0,0,1,3,3,7,4.285714285714286
dr. mario,0,0,0,2,5,7,4.714285714285714
sacred: gold edition - pc,0,0,0,3,4,7,4.571428571428571
tmnt - xbox 360,0,4,2,1,0,7,2.5714285714285716
shogun: total war - pc,0,0,0,4,3,7,4.428571428571429
shinobi iii: return of the ninja master,0,0,0,1,6,7,4.857142857142857
kontrolfreek fps freek cqc thumb grips for playstation 3 and xbox 360 controller,0,0,1,1,5,7,4.571428571428571
tmnt,0,0,0,4,3,7,4.428571428571429
nba jam,0,0,0,2,5,7,4.714285714285714
ultimate combo pack: uncharted greatest hits dual pack & dualshock3 wireless controller - playstation 3,0,0,0,1,6,7,4.857142857142857
resident evil: operation raccoon city special edition - playstation 3,0,1,0,2,4,7,4.285714285714286
spider-man: shattered dimensions - xbox 360,0,0,2,2,3,7,4.142857142857143
mortimer beckett and the lost king [download],0,1,0,0,6,7,4.571428571428571
ps3 racing wheel controller,1,1,0,2,3,7,3.7142857142857144
max payne,0,0,0,2,5,7,4.714285714285714
the smurfs 2 - nintendo wii,1,1,1,3,1,7,3.2857142857142856
official nintendo ds headset,0,2,1,1,3,7,3.7142857142857144
"namco museum, 50th anniversary",0,0,1,1,5,7,4.571428571428571
madden nfl 09 - sony psp,0,2,2,1,2,7,3.4285714285714284
far cry 4 kyrat edition - playstation 4,0,0,0,0,7,7,5.0
tomee wii/gamecube 64mb memory card (1019 blocks),0,0,0,1,6,7,4.857142857142857
psi-ops: the mindgate conspiracy - xbox,0,1,1,0,5,7,4.285714285714286
star wars jedi knight: dark forces ii  (includes mysteries of the sith),0,0,0,1,6,7,4.857142857142857
power pak for wii u,1,0,0,1,5,7,4.285714285714286
nba live 16 - xbox one,0,1,0,4,2,7,4.0
need for speed: hot pursuit 2,1,1,1,1,3,7,3.5714285714285716
"brendo new nintendo 3ds xl, 2ds xl and 3ds carrying case with 24 game cartridge holders and large stylus - black",1,0,1,0,5,7,4.142857142857143
silent hill 3 - pc,0,0,1,1,5,7,4.571428571428571
xbox 360 kinect floor stand,0,1,1,2,3,7,4.0
nyko power adaptor for wii,0,0,0,2,5,7,4.714285714285714
watch dogs deluxe edition [download],1,1,2,0,3,7,3.4285714285714284
frequency,0,0,1,2,4,7,4.428571428571429
nintendo prepaid eshop $20 for 3ds or wii u,3,1,0,0,3,7,2.857142857142857
just dance 2015 - playstation 3,0,0,0,1,6,7,4.857142857142857
asphalt urban gt - nintendo ds,0,0,1,0,6,7,4.714285714285714
need for speed underground - xbox,0,1,1,3,2,7,3.857142857142857
lord of the rings: return of the king - pc,1,0,3,0,3,7,3.5714285714285716
turtle beach - ear force disney infinity: marvel super heroes stereo gaming headset - xbox 360,0,1,1,1,4,7,4.142857142857143
"hyperkin ""gn6"" premium genesis usb controller for pc/ mac",0,1,0,1,5,7,4.428571428571429
shinobido 2: revenge of zen - playstation vita,0,0,2,1,4,7,4.285714285714286
the dark spire - nintendo ds,0,0,2,2,3,7,4.142857142857143
madden nfl 25 anniversary edition with nfl sunday ticket -xbox 360,1,1,2,0,3,7,3.4285714285714284
ridge racer 6 - xbox 360,0,1,0,4,2,7,4.0
blazblue: continuum shift extend - standard edition - playstation 3,0,1,0,2,4,7,4.285714285714286
dishonored: game of the year edition - windows (select),0,0,0,3,4,7,4.571428571428571
supreme commander gold edition - pc,0,0,1,2,4,7,4.428571428571429
fighting force,0,0,2,0,5,7,4.428571428571429
defense grid - pc,0,1,0,1,5,7,4.428571428571429
zoo keeper - nintendo ds,0,0,1,1,5,7,4.571428571428571
pokemon - trading card game,0,1,0,1,5,7,4.428571428571429
mad catz rock band 3 wireless keyboard bundle with rock band 3 software -xbox 360,0,0,0,1,6,7,4.857142857142857
final fantasy xi: the vana'diel collection 2007 - pc,0,2,0,1,4,7,4.0
nightcaster: defeat the darkness,0,2,1,3,1,7,3.4285714285714284
armored core 4 - xbox 360,1,1,2,0,3,7,3.4285714285714284
tiger woods pga tour 07 - playstation 3,0,0,0,3,4,7,4.571428571428571
heavenly guardian - nintendo wii,2,1,1,1,2,7,3.0
skylanders superchargers racing starter pack - nintendo 3ds,0,0,3,2,2,7,3.857142857142857
dead island riptide rigor mortis edition -xbox 360,0,0,1,1,5,7,4.571428571428571
facebreaker - playstation 3,2,2,2,1,0,7,2.2857142857142856
disney infinity 3.0 edition: zootopia power disc pack,0,1,1,0,5,7,4.285714285714286
blazblue: continuum shift extend - standard edition - playstation vita,0,0,1,3,3,7,4.285714285714286
nascar rumble,0,0,0,1,6,7,4.857142857142857
combat flight simulator 3: battle for europe,2,1,1,0,3,7,3.142857142857143
pdp disney infinity play zone,0,0,0,1,6,7,4.857142857142857
major league baseball 2k12 - pc,2,1,0,2,2,7,3.142857142857143
nintendo selects: mario party: island tour,0,1,0,0,6,7,4.571428571428571
official wii speak microphone,3,0,0,1,3,7,3.142857142857143
insassy kinect sensor tv mount clip for xbox 360,0,0,1,3,3,7,4.285714285714286
prince of persia rival swords - nintendo wii,0,1,0,2,4,7,4.285714285714286
hori nintendo 3ds mario protector and skin set,0,0,2,3,2,7,4.0
the sims life stories - pc,0,0,2,1,4,7,4.285714285714286
mortal kombat x - pc [digital code],0,3,1,1,2,7,3.2857142857142856
disney infinity 3.0 edition: star wars twilight of the republic play set,0,0,0,0,7,7,5.0
tomee nes retro classic controller,0,0,1,1,5,7,4.571428571428571
nancy drew: the mystery of the clue bender society,0,0,2,4,1,7,3.857142857142857
devil kings - playstation 2,0,1,1,3,2,7,3.857142857142857
"warhammer 40,000 dawn of war winter assault expansion pack - pc",0,1,2,2,2,7,3.7142857142857144
need for speed 4: high stakes,0,0,0,1,6,7,4.857142857142857
the sims bustin' out - xbox,0,0,0,2,5,7,4.714285714285714
combo wall + car charger for nintendo ds nds lite ndsl,0,0,0,2,5,7,4.714285714285714
sn propad,0,0,1,0,6,7,4.714285714285714
dark souls ii: collector's edition - xbox 360,0,0,0,1,6,7,4.857142857142857
bulletstorm limited edition,0,0,1,2,4,7,4.428571428571429
the amazing spider-man 2 - wii u,0,0,0,0,7,7,5.0
top spin 4 - xbox 360,0,0,1,2,4,7,4.428571428571429
sniper elite - xbox,0,0,1,2,4,7,4.428571428571429
disney princess: enchanting storybooks - nintendo ds,0,0,0,0,7,7,5.0
alone in the dark - nintendo wii,0,2,3,1,1,7,3.142857142857143
stranglehold collector's edition (includes hard boiled) - playstation 3,0,0,3,2,2,7,3.857142857142857
"global game gear ggg0027 bracket for kinect and wii sensor bar, also works with wireless sensor bar",0,0,1,4,2,7,4.142857142857143
demon's souls with soundtrack cd - playstation 3,0,1,0,2,4,7,4.285714285714286
new legends,1,1,3,1,1,7,3.0
duke nukem: land of the babes,0,0,2,2,3,7,4.142857142857143
major league baseball 2k8 - nintendo wii,0,0,2,2,3,7,4.142857142857143
wipeout 2 - xbox 360,0,0,0,2,5,7,4.714285714285714
weird park: the final show [download],1,0,0,2,4,7,4.142857142857143
ea sports ufc 2 (deluxe edition) - playstation 4,1,0,2,0,4,7,3.857142857142857
lego: marvel - pc,0,1,1,1,4,7,4.142857142857143
pokémon red version - 3ds [digital code],0,0,0,2,5,7,4.714285714285714
cirka controller for n64 (black),2,0,1,2,2,7,3.2857142857142856
jewels of the ages (jewels of olympus / jewels of ancient pharaoh's),0,0,0,0,7,7,5.0
the witcher: wild hunt  - windows,0,0,0,0,7,7,5.0
dreamcast retro bit s-av cable,1,0,0,1,5,7,4.285714285714286
ps2 to ps3 controller converter adapter,0,1,2,1,3,7,3.857142857142857
rpg maker 2,3,1,0,1,2,7,2.7142857142857144
spider-man,0,2,0,1,4,7,4.0
nba 2k1 [sega dreamcast],0,1,0,1,5,7,4.428571428571429
blade 2,2,1,1,0,3,7,3.142857142857143
sega dreamcast controller,1,0,1,1,4,7,4.0
xbox one 500 gb console - black [discontinued],1,2,1,1,2,7,3.142857142857143
"microsoft original xbox console with controller, power supply, and av cable,black",1,0,0,2,4,7,4.142857142857143
brothers in arms earned in blood - playstation 2,0,1,1,1,4,7,4.142857142857143
resogun - ps4 [digital code],0,0,1,3,3,7,4.285714285714286
indiana jones and the staff of kings - playstation 2,1,1,1,3,1,7,3.2857142857142856
ultima collection - pc,1,0,2,2,2,7,3.5714285714285716
dance dance revolution extreme 2 - playstation 2,0,0,1,0,6,7,4.714285714285714
punch-out! (nintendo selects),1,0,0,2,4,7,4.142857142857143
mario strikers charged (nintendo selects),0,0,0,2,5,7,4.714285714285714
wario land 3,0,0,0,1,6,7,4.857142857142857
"turtle beach - ear force px3 - programmable wireless gaming headset - ps3, xbox 360",0,0,1,3,3,7,4.285714285714286
vectorman 2 - sega genesis,1,0,0,0,6,7,4.428571428571429
samantha swift 2 and the golden touch,0,1,2,3,1,7,3.5714285714285716
generic super nintendo entertainment system snes generic super nintendo classic controller - nintendo 64,1,0,0,4,2,7,3.857142857142857
[ps4 / ps3 / pc compatible] fighting commander,0,2,0,0,5,7,4.142857142857143
flower - ps4 [digital code],0,0,1,4,2,7,4.142857142857143
"barbie: jet, set & style - nintendo ds",0,0,0,2,5,7,4.714285714285714
men of war - pc,0,1,1,1,4,7,4.142857142857143
hitman contracts - xbox,0,0,1,2,4,7,4.428571428571429
quake 3 arena,0,1,1,2,3,7,4.0
downhill domination,0,0,0,3,4,7,4.571428571428571
odin sphere leifthrasir - playstation vita standard edition,0,0,0,1,6,7,4.857142857142857
monster hunter freedom - sony psp,0,1,0,2,4,7,4.285714285714286
sonic the hedgehog - sega game gear,0,1,0,0,6,7,4.571428571428571
csi: crime scene investigation - dark motives,1,0,1,1,4,7,4.0
spider-man 2 - nintendo ds,0,1,4,1,1,7,3.2857142857142856
kingdom under fire heroes - xbox,0,1,0,3,3,7,4.142857142857143
mlb the show 16 - playstation 3,0,0,2,0,5,7,4.428571428571429
mortimer beckett and the secrets of spooky manor - pc,0,0,2,2,3,7,4.142857142857143
eforcity® av composite cable compatible with sony psp 2000 / psp 3000,0,0,1,4,2,7,4.142857142857143
transformers - autobots,0,0,2,1,4,7,4.285714285714286
ouya wireless controller,0,0,0,1,6,7,4.857142857142857
wii dancing mat,0,0,0,4,3,7,4.428571428571429
singstar '90s (stand alone) - playstation 2,0,0,2,0,5,7,4.428571428571429
spider-man 3 - playstation 3,1,1,0,5,0,7,3.2857142857142856
just dance 2017 - wii,0,3,1,0,3,7,3.4285714285714284
playstation 2 console slim ps2,0,0,0,1,6,7,4.857142857142857
dynasty warriors 8 - xbox 360,0,0,1,3,3,7,4.285714285714286
skylanders swap force exclusive legendary character pack lightcore grim creeper,0,0,0,2,5,7,4.714285714285714
forza motorsport,0,0,0,3,4,7,4.571428571428571
mad catz street fighter v arcade fightstick tes+ for playstation4 and playstation3,0,0,0,1,6,7,4.857142857142857
iron man - pc,4,3,0,0,0,7,1.4285714285714286
lego legends of chima: laval's journey - playstation vita,0,0,1,1,5,7,4.571428571428571
transformers the game - playstation 2,1,2,2,1,1,7,2.857142857142857
tetris evolution - xbox 360,0,0,3,1,3,7,4.0
twisted metal small brawl,0,0,2,1,4,7,4.285714285714286
ice age: dawn of the dinosaurs - playstation 2,1,0,0,1,5,7,4.285714285714286
"16-bit entertainment system(not snes mini, no games included) compatible with super nintendo games",0,1,0,0,6,7,4.571428571428571
transformers the game - nintendo wii,1,1,2,0,3,7,3.4285714285714284
shin megami tensei: devil summoner 2: raidou kuzunoha versus king abaddon,0,0,0,1,6,7,4.857142857142857
dark souls ii: scholar of the first sin - xbox 360,0,0,1,2,3,6,4.333333333333333
super r-type - nintendo super nes,0,0,0,1,5,6,4.833333333333333
"cirka ""s91"" premium controller for snes",0,0,0,2,4,6,4.666666666666667
the sims 3 worlds bundle - pc/mac,0,1,1,1,3,6,4.0
state of decay 2 - xbox one,0,2,0,3,1,6,3.5
the sims 3 expansion bundle - pc/mac,0,0,0,0,6,6,5.0
jurassic park: rampage edition,0,2,1,1,2,6,3.5
6 button arcade pad for sega genesis,1,0,0,1,4,6,4.166666666666667
circle pad cover - nintendo (3ds ll/3ds) black accessory japan inport,0,0,1,0,5,6,4.666666666666667
resident evil 2,0,0,0,1,5,6,4.833333333333333
farming simulator 17 - playstation 4,0,0,1,0,5,6,4.666666666666667
nintendo 64 system - video game console - donkey kong bundle,0,0,0,0,6,6,5.0
socom: u.s. navy seals fireteam bravo 3 - sony psp,0,0,0,3,3,6,4.5
mortal kombat x: kollector's edition - xbox one,0,0,0,1,5,6,4.833333333333333
the sims 3 movie stuff - pc,0,0,1,1,4,6,4.5
sniper elite iii ultimate edition - xbox 360,0,0,0,1,5,6,4.833333333333333
starcraft ii: battle chest - pc/mac,0,1,0,2,3,6,4.166666666666667
donkey kong land 2,0,1,2,0,3,6,3.8333333333333335
spider-man/x-men: arcade's revenge,1,0,1,2,2,6,3.6666666666666665
disney's planes - nintendo wii u,0,0,0,0,6,6,5.0
lego jurassic world - playstation vita,0,0,1,0,5,6,4.666666666666667
disney infinity disney infinity: disney originals (2.0 edition) toy box game discs - not machine specific,0,0,1,2,3,6,4.333333333333333
schizm: mysterious journey - pc,1,1,2,0,2,6,3.1666666666666665
ps3 500 gb gran turismo 5 legacy bundle,1,1,1,1,2,6,3.3333333333333335
gardenscapes 2 [download],0,0,2,0,4,6,4.333333333333333
metal gear solid v - ground zeroes [online game code],0,2,1,0,3,6,3.6666666666666665
hori amiibo trio case for wii u,0,0,1,3,2,6,4.166666666666667
virtua stick - sega saturn,2,0,0,0,4,6,3.6666666666666665
pdp afterglow karga xbox one headset - green,0,1,1,1,3,6,4.0
"lucidsound ls20 powered universal gaming headset (black)-  ps4, xbox one, nintendo switch, psvr, pc, mobile devices",0,1,0,1,4,6,4.333333333333333
titanfall deluxe [online game code],1,0,0,1,4,6,4.166666666666667
disney infinity disney infinity: disney originals (2.0 edition) aladdin toy box pack - not machine specific,0,1,1,0,4,6,4.166666666666667
star trek: bridge crew - playstation vr,0,0,2,1,3,6,4.166666666666667
titanfall 2 - vanguard collector's edition - playstation 4,0,1,0,1,4,6,4.333333333333333
pure chess ps4 - playstation 4,0,0,1,1,4,6,4.5
pdp energizer xbox one controller charger with rechargeable battery pack for two wireless controllers charging station white,0,1,0,0,5,6,4.5
sid meier's civilization v: brave new world,0,0,1,1,4,6,4.5
"sades spirit wolf 7.1 surround stereo sound usb computer gaming headset with microphone,over-the-ear noise isolating,breathing led light for pc gamers (black white)",0,0,0,1,5,6,4.833333333333333
atv offroad fury blazin trails - sony psp,0,0,2,3,1,6,3.8333333333333335
soldier of fortune - pc,0,2,0,2,2,6,3.6666666666666665
the sims 4 get to work [online game code],0,1,0,1,4,6,4.333333333333333
playstation 4 dust cover vertical by foamy lizard ® texoshield (tm) premium nylon dust guard cover [uspto patent pending] for ps4 with back cable port (vertical),0,0,0,2,4,6,4.666666666666667
onechanbara z2: chaos - playstation 4,0,0,2,1,3,6,4.166666666666667
screamride,0,0,2,2,2,6,4.0
nhl 15 - xbox one,2,0,1,0,3,6,3.3333333333333335
pro evolution soccer 2016 - xbox one standard edition,0,0,1,0,5,6,4.666666666666667
hakuoki: stories of the shinsengumi limited edition - playstation 3 limited edition,1,0,1,1,3,6,3.8333333333333335
disney infinity race to space pack (crystal lightning mcqueen and buzz lightyear),2,0,0,2,2,6,3.3333333333333335
zeus: master of olympus - pc,0,0,0,1,5,6,4.833333333333333
star trek: invasion,0,0,1,0,5,6,4.666666666666667
orb controller thumb grips 4-pack (ps4),0,0,0,0,6,6,5.0
pokémon blue version - 3ds [digital code],1,0,0,0,5,6,4.333333333333333
fire emblem fates: conquest dlc - 3ds [digital code],0,0,0,2,4,6,4.666666666666667
need for speed: high stakes - pc,0,0,1,2,3,6,4.333333333333333
roller coaster tycoon expansion pack: corkscrew follies - pc,0,0,1,1,4,6,4.5
homeworld: game of the year edition - pc,0,1,0,3,2,6,4.0
rock candy wired controller for xbox one - blueberry boom,0,0,0,2,4,6,4.666666666666667
mechwarrior 3 - pc,0,0,2,3,1,6,3.8333333333333335
sony playstation 2 console - black,1,0,1,1,3,6,3.8333333333333335
dreamgear comfort grip for playstation vita slim (pch-2000),0,0,0,0,6,6,5.0
killzone shadow fall - ps4 [digital code],0,0,1,1,4,6,4.5
command & conquer: red alert - pc,0,0,2,1,3,6,4.166666666666667
witch's pranks: frog's fortune (premium edition) [download],0,1,0,1,4,6,4.333333333333333
mortal kombat gold,0,1,2,1,2,6,3.6666666666666665
omega boost,1,0,1,2,2,6,3.6666666666666665
overwatch - collector's edition - pc,0,0,0,1,5,6,4.833333333333333
dishonored [online game code],0,0,1,1,4,6,4.5
fallout: new vegas [online game code],0,0,0,2,4,6,4.666666666666667
mortal kombat mythologies: sub-zero,1,0,2,0,3,6,3.6666666666666665
the elder scrolls v: skyrim dlc: hearthfire [online game code],0,0,1,1,4,6,4.5
tetris attack,0,0,0,0,6,6,5.0
bluecell set of 14 pcs game control/controller joystick pad cover for sony playstation psv ps vita,0,0,3,1,2,6,3.8333333333333335
sonic the hedgehog 2,0,0,0,1,5,6,4.833333333333333
aidyn chronicles: the first mage,1,0,0,2,3,6,4.0
nintendo selects: nes remix pack,0,0,0,2,4,6,4.666666666666667
south park: the stick of truth grand wizard edition - xbox 360 collectors edition,0,0,0,0,6,6,5.0
nintendo selects: donkey kong country returns,1,0,0,0,5,6,4.333333333333333
xcom: enemy within [online game code],0,0,0,0,6,6,5.0
"tontec ps4 cooling stand with 4 charging docks playstation 4 charging station accessories dualshock 4 controller charger, 2 usb charging ports, 4 usb hub",0,0,1,2,3,6,4.333333333333333
d2 - sega dreamcast,1,1,1,1,2,6,3.3333333333333335
disney fantasia: music evolved - xbox 360,1,0,1,1,3,6,3.8333333333333335
the wolf among us [download],0,0,0,1,5,6,4.833333333333333
shadow warrior,0,1,0,1,4,6,4.333333333333333
caesar iii [download],2,0,1,0,3,6,3.3333333333333335
dragon's prophet [download],1,0,3,1,1,6,3.1666666666666665
gameboy pocket system yellow,0,0,0,2,4,6,4.666666666666667
bloodborne: the old hunters - ps4 [digital code],0,0,0,1,5,6,4.833333333333333
just dance 2016 - xbox 360,0,1,0,0,5,6,4.5
plants vs. zombies garden warfare 2 (deluxe edition) - playstation 4,0,0,0,0,6,6,5.0
who wants to be a millionaire - pc,2,3,0,1,0,6,2.0
fifa 15 (ultimate edition) - xbox one,1,0,1,0,4,6,4.0
fairy fencer f: advent dark force - playstation 4,0,0,3,2,1,6,3.6666666666666665
megatagmension blanc + neptune vs zombies - playstation vita,0,0,0,1,5,6,4.833333333333333
sacrifice - pc,1,0,0,3,2,6,3.8333333333333335
transformers devastation - playstation 3,0,0,1,0,5,6,4.666666666666667
new amiibo gold mario japan ver. super smash bros wii u 3ds import,0,1,0,0,5,6,4.5
tom clancys ghost recon wildlands - pc,1,0,1,2,2,6,3.6666666666666665
afterglow lvl 5+ for xbox one,0,1,1,0,4,6,4.166666666666667
life is strange - xbox one,0,0,0,1,5,6,4.833333333333333
usb external 5-fan super turbo temperature cooling fan cooler for sony playstation 4 ps4 gaming console with free usb cable black [playstation 4],0,0,3,1,2,6,3.8333333333333335
mighty morphin power rangers,0,0,1,1,4,6,4.5
life is strange limited edition - xbox one,0,1,1,1,3,6,4.0
sid meier's civilization v: the complete edition - pc,0,0,0,2,4,6,4.666666666666667
star wars: the old republic - 5500 cartel coins + exclusive item [online game code],0,0,0,1,5,6,4.833333333333333
hyperdimension neptunia pp - playstation vita,0,0,0,1,5,6,4.833333333333333
skylanders superchargers: vehicle jet stream character pack,0,0,0,1,5,6,4.833333333333333
cooking mama 5: bon appetit! - nintendo 3ds standard edition,0,0,0,3,3,6,4.5
skylanders swap force nitro freeze blade (exclusive edition!),0,0,0,1,5,6,4.833333333333333
dualshock 4 wireless controller for playstation 4 - call of duty limited edition,0,0,0,1,5,6,4.833333333333333
elder scrolls online: imperial edition,0,0,1,1,4,6,4.5
the elder scrolls online: imperial edition - pc/mac,0,0,0,0,6,6,5.0
sid meier's alpha centauri - pc,1,0,0,1,4,6,4.166666666666667
skylanders superchargers: drivers lava lance eruptor character pack,0,0,0,0,6,6,5.0
b-17 flying fortress - pc,0,0,0,0,6,6,5.0
far cry 4 complete edition - xbox one,0,0,1,1,4,6,4.5
the sims 4 get together  [online game code],0,1,0,0,5,6,4.5
rambo - nintendo nes,0,0,2,1,3,6,4.166666666666667
hori fighting stick mini 4 for playstation 4 and 3,0,1,0,1,4,6,4.333333333333333
mad max [online game code],0,0,0,3,3,6,4.5
baitaihem tv mounting clip mount stand holder for playstation 4 ps4 camera sensor,1,0,1,0,4,6,4.0
warcraft 2 battle.net edition,0,0,0,0,6,6,5.0
"astro gaming a40 tr  gaming headset for pc, mac- white",2,0,0,1,3,6,3.5
gardening mama 2: forest friends - nintendo 3ds,0,0,0,2,4,6,4.666666666666667
2014 fifa world cup brazil (xbox 360),0,0,0,1,5,6,4.833333333333333
wii u fit meter green & white (bulk packaging),0,0,0,0,6,6,5.0
xbox 360 limited edition chrome series wireless controller - black,0,0,0,2,4,6,4.666666666666667
frogger,1,0,1,0,4,6,4.0
xbox one 1 tb console -  fallout 4 bundle,2,0,0,2,2,6,3.3333333333333335
the crew wild run edition - xbox one,0,0,2,1,3,6,4.166666666666667
xcom: enemy unknown complete edition,0,0,0,3,3,6,4.5
ps3 azurite 250gb system with playstation all-stars battle royale bundle,0,0,0,1,5,6,4.833333333333333
darkstalkers 3,0,0,0,2,4,6,4.666666666666667
ortz ps4 vertical stand with cooling fan [limited edition -white],1,0,0,0,5,6,4.333333333333333
"khanka all-in-one double compartment carry travel case bag + gray game/memory card hard case for psvita ps vita 1000 and psvita slim (psv 2000), fits charger cable/game cards",0,0,0,2,4,6,4.666666666666667
nintendo 3ds xl battery replacement spr-003 (not compatible with regular 3ds),0,0,1,1,4,6,4.5
carmageddon 2: carpocalypse now - pc,0,1,2,1,2,6,3.6666666666666665
green yarn big yoshi amiibo - wii u (yoshi woolly world) [japan import] by nintendo,1,0,0,0,5,6,4.333333333333333
grid autosport: black edition - xbox 360,0,1,2,1,2,6,3.6666666666666665
collective minds trigger grips for xbox one,0,0,2,2,2,6,4.0
yoshi,0,0,1,2,3,6,4.333333333333333
heroes of might and magic iii,0,0,2,2,2,6,4.0
dragon warrior ii - nintendo nes,0,0,2,1,3,6,4.166666666666667
sword art online re: hollow fragment - ps4 [digital code],2,0,0,0,4,6,3.6666666666666665
metal gear solid v: the phantom pain [online game code],1,0,2,0,3,6,3.6666666666666665
nintendo 3ds xl - red/black,0,0,0,2,4,6,4.666666666666667
"replacement 1200mah psp-s110 psps110 battery for sony psp slim portable playstation psp-2000, psp-2001, psp-3000, psp-3001, psp-3002, psp-3004",1,0,0,2,3,6,4.0
hellfire: diablo expansion,0,1,0,1,4,6,4.333333333333333
the sims 4: spooky stuff pack [online game code],1,0,1,1,3,6,3.8333333333333335
xbox one 500gb console with kinect bundle (includes chat headset),3,0,0,0,3,6,3.0
"official nintendo mario travel case for nintendo 3ds, 3ds xl, ds, dsi & dsi xl",0,0,0,2,4,6,4.666666666666667
the little mermaid,0,2,1,0,3,6,3.6666666666666665
kontrolfreek fps freek cqc signature - ps4,1,0,0,1,4,6,4.166666666666667
sony playstation vita wi-fi (certified refurbished),0,0,0,3,3,6,4.5
road rash 64,0,1,0,0,5,6,4.5
wasteland 2: director's cut,0,1,1,0,4,6,4.166666666666667
pdp afterglow dolby prismatic wireless headset - ps4/ps3/xbox 360,1,1,1,2,1,6,3.1666666666666665
disney infinity 3.0 edition: disneypixar's sadness figure,0,0,0,1,5,6,4.833333333333333
pokemon puzzle challenge,1,0,0,0,5,6,4.333333333333333
apocalypse,0,0,1,1,4,6,4.5
hatsune miku: project diva x - playstation vita,0,0,0,0,6,6,5.0
sebastien loeb rally evo - playstation 4,1,0,1,2,2,6,3.6666666666666665
mega man legends 2,1,0,0,0,5,6,4.333333333333333
phantasy star iv - sega genesis,0,0,0,1,5,6,4.833333333333333
tomba! 2: the evil swine return,0,0,1,1,4,6,4.5
tokyo mirage sessions #fe : special edition - wii u special edition,0,0,0,0,6,6,5.0
zumba fitness world party - nintendo wii u,0,0,0,3,3,6,4.5
hde headset for xbox 360 console and live service two pack headphone and microphone for game chat compatible with wireless controllers (2pk),0,0,0,1,5,6,4.833333333333333
angry birds trilogy - nintendo wii,0,0,1,3,2,6,4.166666666666667
venom/spider-man: separation anxiety,0,0,0,2,4,6,4.666666666666667
star wars: battlefront - standard edition - pc [download code],3,1,0,1,1,6,2.3333333333333335
dragon warrior i & ii,0,0,0,1,5,6,4.833333333333333
1000 emp: tera: rising [instant access],1,0,1,1,3,6,3.8333333333333335
corpse party: back to school edition - nintendo 3ds,0,0,0,2,4,6,4.666666666666667
10 pcs/lot clear plastic game cartridge card box case cover for game boy gba sp gbm,0,0,0,0,6,6,5.0
disney infinity: toy box starter pack (2.0 edition) - wii u,0,0,0,1,5,6,4.833333333333333
xbox one special edition armed forces stereo headset,0,0,0,1,5,6,4.833333333333333
assassin's creed iv black flag limited edition - playstation 3,0,0,0,0,6,6,5.0
superdimension neptune vs sega hard girls - playstation vita,1,0,0,1,4,6,4.166666666666667
"beskit 10pcs plastic touch stylus pen only for nintendo new 3ds xl and new 3ds ll (do not fit for ""3ds xl"", ""new 3ds"", ""3ds"" and ""2ds"")",0,0,0,0,6,6,5.0
legend of the mystical ninja - nintendo super nes,0,1,1,1,3,6,4.0
f1 2013 - playstation 3,0,0,0,1,5,6,4.833333333333333
mario paint,0,0,3,0,3,6,4.0
ratchet & clank - ps4 [digital code],0,0,1,0,5,6,4.666666666666667
pdp rock candy wired controller for xbox 360 - aqualime,1,0,1,2,2,6,3.6666666666666665
playstation 4 knack launch day bundle,1,0,0,1,4,6,4.166666666666667
gears of war 4 - standard edition - xbox one/windows 10 [digital code],0,0,0,1,5,6,4.833333333333333
sega genesis controller,0,0,0,1,5,6,4.833333333333333
real myst,2,0,1,2,1,6,3.0
mortal kombat komplete edition - pc,1,0,0,1,4,6,4.166666666666667
pdp pop n display question block,0,0,0,0,6,6,5.0
pdp legendary collection deliverer of truth controller for xbox one & windows,1,0,2,1,2,6,3.5
ps3 250 gb uncharted 3 and ps plus bundle,0,0,0,1,5,6,4.833333333333333
assassin's creed: the americas collection - xbox 360 standard edition,0,0,1,1,4,6,4.5
tpu duraflexi cover for new nintendo 3ds ll [japan import],0,0,1,1,4,6,4.5
fifa 17 - playstation 3,0,0,0,2,4,6,4.666666666666667
farming simulator 15 - xbox one,0,1,0,0,5,6,4.5
rocksmith 2014 edition - no cable included for rocksmith owners,1,1,1,1,2,6,3.3333333333333335
hyperdimension neptunia re;birth3: v generation - playstation vita,0,0,0,2,4,6,4.666666666666667
toejam & earl in panic on funkotron,0,0,0,1,5,6,4.833333333333333
nba 2k14 [online game code],1,0,0,0,5,6,4.333333333333333
nintendo splatoon series 3-pack (alt colors) amiibo - nintendo wii u,1,0,1,1,3,6,3.8333333333333335
zombies ate my neighbors - sega genesis,0,0,0,0,6,6,5.0
sim city,0,0,0,1,5,6,4.833333333333333
f1 2015 (formula one) - xbox one,0,1,0,1,4,6,4.333333333333333
zoo tycoon - xbox 360,0,0,0,2,4,6,4.666666666666667
super street fighter ii,0,0,0,2,4,6,4.666666666666667
evergrace,1,1,1,2,1,6,3.1666666666666665
playstation4 glacier white 500gb (cuh1100ab02)(japan import),0,0,2,0,4,6,4.333333333333333
eternal ring - playstation 2,1,1,2,0,2,6,3.1666666666666665
einhander,0,0,0,1,5,6,4.833333333333333
payday 2 [online game code],0,0,0,3,3,6,4.5
madden nfl 17 - standard edition - xbox 360,0,0,1,2,3,6,4.333333333333333
"apple certified mad catz c.t.r.l.i mobile gamepad and game controller mfi made for apple tv, iphone, and ipad - black",0,0,0,3,3,6,4.5
call of duty: advanced warfare atlas limited edition - playstation 4,1,1,1,0,3,6,3.5
madden nfl 16 - deluxe edition - xbox one,2,1,1,0,2,6,2.8333333333333335
the jungle book,0,1,0,0,5,6,4.5
co2crea semi-hard eva shockproof carrying travel case for sony playstation vita psvita 1000 2000 (slim version) psv1000 psv2000 psv 1000 2000,0,0,0,0,6,6,5.0
the legend of korra a new era begins - nintendo 3ds,1,1,0,1,3,6,3.6666666666666665
marvel ear force seven,0,0,0,3,3,6,4.5
doom [online game code],1,1,0,0,4,6,3.8333333333333335
dreamgear – ps4 led charge cable for dualshock4 controllers – leds indicate when charging and charged,1,3,0,0,2,6,2.8333333333333335
the sims 4 - romantic garden stuff [online game code],0,0,1,2,3,6,4.333333333333333
hori elite pack protective starter kit for playstation vita 2000,1,0,0,0,5,6,4.333333333333333
light blue yarn yoshi amiibo - japan import (yoshi's woolly world series),0,0,0,0,6,6,5.0
unravel - ps4 [digital code],0,0,0,0,6,6,5.0
world of tanks-x360 xbox 360 english us ntsc dvd - xbox 360,2,0,1,1,2,6,3.1666666666666665
green yarn yoshi amiibo - japan import (yoshi's woolly world series),0,0,0,0,6,6,5.0
top gear,0,0,0,2,4,6,4.666666666666667
pokemon rumble world - nintendo 3ds standard edition,0,0,0,1,5,6,4.833333333333333
scooby-doo: classic creep capers,0,2,0,1,3,6,3.8333333333333335
ps vita slim - lime green / white - wi-fi (pch-2000za13),0,0,0,2,4,6,4.666666666666667
the walking dead: season 2 - xbox 360,1,0,1,2,2,6,3.6666666666666665
dreamgear  xbox one dual charging dock.  charge up to two xbox one controllers simultaneously,0,1,0,1,4,6,4.333333333333333
skylanders superchargers starter pack - xbox 360,0,0,1,0,5,6,4.666666666666667
motogp 14 - playstation 4,2,0,0,0,4,6,3.6666666666666665
"turtle beach - ear force recon 60p amplified stereo gaming headset – ps4, xbox one (compatible w/ xbox one controller w/ 3.5mm headset jack), and ps3",0,0,0,0,6,6,5.0
brave fencer musashi,0,0,1,2,3,6,4.333333333333333
"afterglow wireless controller, blue - playstation 3",0,0,0,1,5,6,4.833333333333333
"turtle beach - ear force px24 multi-platform amplified gaming headset - superhuman hearing - ps4, xbox one, pc (discontinued by manufacturer)",0,0,2,3,1,6,3.8333333333333335
the sims 4 - movie hangout stuff [online game code],0,0,0,2,4,6,4.666666666666667
big city adventure: london classic [download],0,0,1,2,3,6,4.333333333333333
riddle of the sphinx - pc,1,0,4,1,0,6,2.8333333333333335
madden nfl 16 - deluxe edition - playstation 4,0,0,0,0,6,6,5.0
nba 2k16 : early tip-off edition - xbox one,0,0,1,0,5,6,4.666666666666667
technoskin - all in one travel carrying case for new 3ds or new 3ds xl - black and red - 12 game holders - charger pouch,0,0,0,2,4,6,4.666666666666667
final fantasy xv deluxe edition - xbox one,0,0,0,1,5,6,4.833333333333333
"mudder protective travel carrying case cover for nintendo 2ds, red",0,0,2,1,3,6,4.166666666666667
homefront: the revolution - pc,1,1,1,2,1,6,3.1666666666666665
master of orion 2: battle at antares (jewel case) - pc,0,0,1,0,5,6,4.666666666666667
nhl 16 - deluxe edition - playstation 4,1,0,2,0,3,6,3.6666666666666665
nba jam,0,0,0,1,5,6,4.833333333333333
road runner's death valley rally - nintendo super nes,0,1,1,0,4,6,4.166666666666667
spider-man venom maximum carnage limited edition super nintendo,0,0,0,3,3,6,4.5
rbi baseball 2016 - xbox one,2,0,1,0,3,6,3.3333333333333335
sunset riders,0,1,1,0,4,6,4.166666666666667
the sims 4 luxury party stuff [online game code],0,0,1,3,2,6,4.166666666666667
ortz® xbox one battery pack - rechargeable 2400 mah for wireless controller - play kit with micro usb charging cable - charges under 4 hours - battery life 25 hours of gameplay - best accessory for charging station - 1 year warranty,1,0,0,1,4,6,4.166666666666667
nba jam: tournament edition,0,0,0,3,3,6,4.5
delta force land warrior - pc,0,0,2,1,3,6,4.166666666666667
the sims 3 into the future  [online game code],0,0,1,2,3,6,4.333333333333333
bomberman hero,0,0,0,0,6,6,5.0
fifa 16 - standard edition - xbox one,1,0,0,0,5,6,4.333333333333333
mario & sonic at the rio 2016 olympic games - wii u standard edition,1,0,0,2,3,6,4.0
destiny limited edition - xbox 360,1,0,0,1,4,6,4.166666666666667
6' s-video cable for playstation 2 (black),2,0,0,0,4,6,3.6666666666666665
destiny: ghost edition,3,0,0,2,1,6,2.6666666666666665
nintendo 3ds xl pink/white - nintendo 3ds xl,0,1,0,0,5,6,4.5
nintendo 3ds cosmo black - nintendo 3ds,0,0,0,0,6,6,5.0
nintendo selects: animal crossing: new leaf welcome amiibo - 3ds [digital code],0,0,0,1,5,6,4.833333333333333
anno 2070,1,0,1,2,2,6,3.6666666666666665
gun metal,1,1,2,1,1,6,3.0
tmnt - nintendo wii,0,0,2,2,2,6,4.0
juiced 2: hot import nights - playstation 3,1,0,0,1,4,6,4.166666666666667
bleach: shattered blade,0,2,1,0,3,6,3.6666666666666665
dreamgear dgps3-1394 radium wireless controller for ps3,0,0,0,2,4,6,4.666666666666667
advent rising - pc,2,1,0,1,2,6,3.0
chessmaster 10th edition - pc,1,0,1,1,3,6,3.8333333333333335
the godfather the don's edition -playstation 3,1,1,0,2,2,6,3.5
f-zero gp legend,0,0,0,1,5,6,4.833333333333333
combat of giants dinosaurs,0,0,1,2,3,6,4.333333333333333
singstar pop vol. 2 - playstation 2,0,0,0,0,6,6,5.0
trivial pursuit - bet you know it - nintendo wii,0,0,0,1,5,6,4.833333333333333
terraria collector's edition,0,0,0,1,5,6,4.833333333333333
nyko vertical stand for ps3,1,0,2,2,1,6,3.3333333333333335
tetris worlds - playstation 2,0,0,4,1,1,6,3.5
x-men: the official game,0,1,3,0,2,6,3.5
x-men: the official game - playstation 2,0,0,1,1,4,6,4.5
ape escape 2,0,0,0,3,3,6,4.5
xbox controller (original design),0,0,1,3,2,6,4.166666666666667
il-2 sturmovik: birds of prey,0,1,1,3,1,6,3.6666666666666665
the sims 3: pets - nintendo 3ds,0,0,1,2,3,6,4.333333333333333
the sims: bustin' out,1,0,0,1,4,6,4.166666666666667
wii lan adapter,2,0,0,0,4,6,3.6666666666666665
jade cocoon 2,1,0,1,3,1,6,3.5
shellshock 2: blood trails - playstation 3,3,1,0,2,0,6,2.1666666666666665
dr. mario,0,0,1,2,3,6,4.333333333333333
michael jackson the experience - nintendo 3ds,0,0,1,1,4,6,4.5
tiger woods pga tour 08 - nintendo wii,0,0,0,2,4,6,4.666666666666667
mortal kombat deception - gamecube,0,0,0,1,5,6,4.833333333333333
crysis collector's edition - pc,0,0,1,1,4,6,4.5
alan wake collector's bundle [download],1,1,1,0,3,6,3.5
ps3 slim multi function carry bag,0,1,0,1,4,6,4.333333333333333
shrek's carnival craze party games - nintendo wii,0,2,0,0,4,6,4.0
heroes of might and magic iv,0,0,2,2,2,6,4.0
codename: panzers phase one,0,0,1,2,3,6,4.333333333333333
soul bubbles - nintendo ds,0,0,0,1,5,6,4.833333333333333
nba live 09 - xbox 360,1,1,0,2,2,6,3.5
halo reach full game download card,0,0,1,1,4,6,4.5
amnesia [download],1,0,0,1,4,6,4.166666666666667
nintendo wii fit - protective silicone cover,2,0,0,4,0,6,3.0
the sims 3: hidden springs,0,0,0,1,5,6,4.833333333333333
cake mania [download],0,1,2,2,1,6,3.5
super swing golf season 2 - nintendo wii,0,0,1,2,3,6,4.333333333333333
rayman ds,0,0,1,1,4,6,4.5
naruto: uzumaki chronicles - playstation 2,1,0,0,2,3,6,4.0
spiderman: friend or foe,0,0,1,2,3,6,4.333333333333333
command & conquer 3: tiberium wars - kane edition - pc,0,0,1,4,1,6,4.0
hori ps vita grip attachment,0,0,0,2,4,6,4.666666666666667
battleship xbox 360,1,2,2,0,1,6,2.6666666666666665
sony playstation (psone) dual shock controller - white,0,0,0,2,4,6,4.666666666666667
supreme commander: forged alliance - pc,0,0,1,0,5,6,4.666666666666667
playstation 3 cordless mediaboard keyboard,0,0,1,1,4,6,4.5
guitar hero: warriors of rock stand-alone software - nintendo wii,0,0,1,1,4,6,4.5
guitar hero ii/guitar hero aerosmith dual pack,1,0,0,2,3,6,4.0
xbox 360 limited edition red wireless controller and play & charge kit,0,0,0,2,4,6,4.666666666666667
planet puzzle league - nintendo ds,1,0,1,3,1,6,3.5
nintendo 3ds game card case 24 - blue,0,0,0,1,5,6,4.833333333333333
mario golf advance tour,1,1,0,2,2,6,3.5
tony hawk's proving ground - xbox 360,1,2,1,0,2,6,3.0
nerf-n-strike bundle - nintendo wii,0,0,2,1,3,6,4.166666666666667
test drive unlimited dvd-rom - pc,2,0,0,2,2,6,3.3333333333333335
nintendo 3ds game card case 24 - clear,0,0,0,0,6,6,5.0
"painkiller triple dose (painkiller, painkiller: battle out of hell, painkiller: overdose) - pc",1,0,1,1,3,6,3.8333333333333335
urbz: sims in the city - nintendo ds,0,1,2,1,2,6,3.6666666666666665
"go, diego, go!: great dinosaur rescue - nintendo wii",0,0,0,1,5,6,4.833333333333333
zoo tycoon expansion pack: marine mania - pc,1,0,0,0,5,6,4.333333333333333
nascar thunder 2002,0,1,0,1,4,6,4.333333333333333
playstation 3 320gb hw bundle - call of duty: modern warfare 3,0,0,1,0,5,6,4.666666666666667
britney's dance beat,0,2,1,2,1,6,3.3333333333333335
nintendo nes game cartridge dust cover/sleeve,0,0,0,0,6,6,5.0
disney princess: my fairytale adventure - nintendo 3ds,0,0,1,1,4,6,4.5
star trek voyager: elite force,0,0,0,1,5,6,4.833333333333333
insten 2 packs of reusable screen protectors compatible with sony playstation vita pch-1000 (ps vita),0,0,1,0,5,6,4.666666666666667
comfort grip for original 3ds (not the “new”  version) – silicone protective cover gives your 3ds armor - (transparent black),1,1,0,2,2,6,3.5
nintendo 3ds portable gaming console - purple,0,0,0,0,6,6,5.0
xbox precision controller,0,0,1,2,3,6,4.333333333333333
playstation 3 broadcaster headset,2,1,0,1,2,6,3.0
sands of destruction - nintendo ds,0,0,0,5,1,6,4.166666666666667
mafia ii [download],0,1,1,1,3,6,4.0
jillian michael's fitness ultamatum 2009 - nintendo wii,2,1,1,1,1,6,2.6666666666666665
rock revolution - xbox 360 (game),0,1,2,2,1,6,3.5
don king presents: prize fighter - xbox 360,0,0,3,1,2,6,3.8333333333333335
phantom brave (special edition),0,0,1,2,3,6,4.333333333333333
xbox 360 versus controller,0,2,1,1,2,6,3.5
prototype 2 [online game code],0,0,1,2,3,6,4.333333333333333
madden nfl 2006 - sony psp,2,1,2,1,0,6,2.3333333333333335
transformers: dark of the moon - nintendo 3ds (stealth force),0,1,0,0,5,6,4.5
mario power tennis (nintendo selects),0,1,0,1,4,6,4.333333333333333
gurumin: a monstrous adventure - sony psp,0,0,1,2,3,6,4.333333333333333
rio - nintendo wii,0,0,2,4,0,6,3.6666666666666665
nascar the game: inside line,0,0,0,1,5,6,4.833333333333333
ncaa football 2006 - xbox,0,0,1,3,2,6,4.166666666666667
driving force wheel for playstation 2 and playstation 3,0,0,0,2,4,6,4.666666666666667
playstation network card - $10,1,0,0,0,5,6,4.333333333333333
hde silicone skin for xbox 360 controllers rubberized protective cover for microsoft xbox 360 wired and wireless gamepads (green),2,0,0,0,4,6,3.6666666666666665
monster 4x4: world circuit (with wheel) - nintendo wii,0,0,0,0,6,6,5.0
x-men origins: wolverine - uncaged edition - pc,0,0,2,1,3,6,4.166666666666667
super street fighter ii- turbo revival,0,0,1,2,3,6,4.333333333333333
starfox adventures,0,0,1,0,5,6,4.666666666666667
metal slug advance,0,0,1,3,2,6,4.166666666666667
front mission - nintendo ds,0,1,0,1,4,6,4.333333333333333
"metro: last light, limited edition - playstation 3",3,1,0,0,2,6,2.5
the urbz: sims in the city - gamecube,0,0,0,3,3,6,4.5
cars,2,1,0,1,2,6,3.0
luminous arc - nintendo ds,0,0,1,4,1,6,4.0
"skylanders spyro's adventure triple character pack (cynder, lightning rod, zook)",0,0,0,2,4,6,4.666666666666667
darksiders ii [download],1,2,0,1,2,6,3.1666666666666665
nba live 2002,0,2,0,2,2,6,3.6666666666666665
"metro: last light, limited edition - pc",0,0,0,2,4,6,4.666666666666667
gamecube s-video cable (bulk packaging),0,0,2,0,4,6,4.333333333333333
nyko kama for wii,0,1,3,1,1,6,3.3333333333333335
tom clancy's ghost recon,0,1,2,2,1,6,3.5
call of duty: world at war greatest hits final fronts - playstation 2,0,0,0,1,5,6,4.833333333333333
motionsports: adrenaline - xbox 360,0,0,3,2,1,6,3.6666666666666665
"call of duty: war chest (includes call of duty, call of duty: united offensive expansion pack, & call of duty 2)",0,0,1,1,4,6,4.5
assassin's creed altair's chronicles - nintendo ds,0,1,3,0,2,6,3.5
again - nintendo ds,0,1,2,1,2,6,3.6666666666666665
railroad tycoon 3 - pc,0,1,1,2,2,6,3.8333333333333335
ubersoldier - pc,1,2,1,2,0,6,2.6666666666666665
starter kit - aqua blue for 3ds,0,0,1,1,4,6,4.5
nba inside drive 2002,0,1,3,1,1,6,3.3333333333333335
lunar: silver star harmony limited edition -sony psp,0,1,1,1,3,6,4.0
brave - nintendo wii,0,0,1,2,3,6,4.333333333333333
saint seiya sanctuary battle (playstation 3),0,0,0,1,5,6,4.833333333333333
midnight mysteries: haunted houdini - standard edition [download],0,0,0,1,5,6,4.833333333333333
natural threat: ominous shores [download],0,0,2,1,3,6,4.166666666666667
omerta: city of gangsters - xbox 360,0,1,1,2,2,6,3.8333333333333335
tiger woods pga tour 2002,0,0,1,1,4,6,4.5
doom 2 (jewel case) - pc,0,0,0,3,3,6,4.5
xbox 360 street fighter iv fightpad - chun-li,1,1,0,3,1,6,3.3333333333333335
mortal kombat:  deception (premium pack),0,0,1,2,3,6,4.333333333333333
back to the future- the game - nintendo wii,1,0,2,0,3,6,3.6666666666666665
spectrobes - nintendo ds,1,0,0,3,2,6,3.8333333333333335
powera skylanders carrying case,0,0,1,3,2,6,4.166666666666667
the legend of spyro: the eternal night - nintendo wii,1,0,1,0,4,6,4.0
microsoft flight simulator 2004: a century of flight - pc,0,0,1,2,3,6,4.333333333333333
a vampyre story - pc,0,0,1,3,2,6,4.166666666666667
psp umd soft case - colors may vary,0,1,1,3,1,6,3.6666666666666665
"warhammer 40,000: space marine [download]",0,0,1,3,2,6,4.166666666666667
bandai namco mobil suit gundam extreme vs. for ps3 [japan import],0,0,0,1,5,6,4.833333333333333
contra hard corps,0,0,0,1,5,6,4.833333333333333
nyko charge station quad for wii,0,0,1,2,3,6,4.333333333333333
playstation 3 160gb system with ratchet & clank future: a crack in time and singstar dance party pack - family bundle,0,0,0,0,6,6,5.0
freelancer (jewel case),0,0,1,0,5,6,4.666666666666667
time hollow - nintendo ds,0,0,1,1,4,6,4.5
xbox 360 wireless controller blue,0,0,0,0,6,6,5.0
pac-man [download],0,0,1,0,5,6,4.666666666666667
csi: fatal conspiracy - playstation 3,0,1,0,1,4,6,4.333333333333333
batman vengeance,1,2,1,2,0,6,2.6666666666666665
dungeons - pc,3,1,0,1,1,6,2.3333333333333335
naruto shippuden: dragon blade chronicles - nintendo wii,0,1,0,1,4,6,4.333333333333333
tony hawk's downhill jam - nintendo wii,0,0,2,1,3,6,4.166666666666667
cirka controller for n64 (red),0,1,1,2,2,6,3.8333333333333335
yourself fitness,0,0,1,0,5,6,4.666666666666667
amped 2,0,0,0,2,4,6,4.666666666666667
inuyasha: secret of the cursed mask,0,0,1,0,5,6,4.666666666666667
300: march to glory,0,2,0,3,1,6,3.5
abba you can dance,0,0,0,3,3,6,4.5
naruto shippuden: ultimate ninja storm generations - playstation 3 (limited),0,0,2,0,4,6,4.333333333333333
minute to win it - nintendo wii,1,0,1,1,3,6,3.8333333333333335
wii fit workout kit (green),0,0,2,0,4,6,4.333333333333333
space channel 5,0,0,0,2,4,6,4.666666666666667
deus ex: human revolution - augmented edition [download],0,1,1,1,3,6,4.0
touchmaster 2 - nintendo ds,2,0,1,0,3,6,3.3333333333333335
eyepet with camera - sony psp,0,0,0,1,5,6,4.833333333333333
xbox 360 elite console 120gb with 2 bonus games,0,1,1,1,3,6,4.0
cooking mama world kitchen,0,0,2,2,2,6,4.0
turtle beach - ear force xl1 gaming headset - amplified stereo - xbox 360,1,0,1,2,2,6,3.6666666666666665
lego star wars: the video game,0,0,0,4,2,6,4.333333333333333
nfl fever 2003 (xbox),0,0,0,4,2,6,4.333333333333333
ssx 3 - gamecube,1,0,1,2,2,6,3.6666666666666665
race 07: official wtcc game,0,0,1,3,2,6,4.166666666666667
need for speed: underground 2 - pc,0,1,1,0,4,6,4.166666666666667
ncis: based on the tv series - nintendo 3ds,0,0,0,3,3,6,4.5
turtle beach call of duty: mw3 ear force bravo limited edition programmable wireless universal gaming headset,0,0,0,1,5,6,4.833333333333333
jane's advance strike fighters - xbox 360,1,0,3,0,2,6,3.3333333333333335
dance dance revolution x - playstation 2,1,0,0,0,5,6,4.333333333333333
drawn: painted tower / dark flight,0,0,1,1,4,6,4.5
dead space 2 [limited edition],0,0,0,2,4,6,4.666666666666667
blood rayne 2 - pc,0,0,1,2,3,6,4.333333333333333
rock band 2 triple cymbal expansion kit,0,0,0,2,4,6,4.666666666666667
history channel civil war: a nation divided - xbox 360,0,2,2,1,1,6,3.1666666666666665
ms. pac-man,0,0,0,1,5,6,4.833333333333333
csi: miami - pc,1,0,1,1,3,6,3.8333333333333335
you don't know jack - playstation 3,0,0,0,0,6,6,5.0
spore creatures - nintendo ds (creature),0,1,1,1,3,6,4.0
sonic r: sega saturn,1,0,1,2,2,6,3.6666666666666665
tecmo bowl: kickoff - nintendo ds,0,1,2,0,3,6,3.8333333333333335
furu furu park - nintendo wii,0,4,1,0,1,6,2.6666666666666665
grandia xtreme,1,0,0,1,4,6,4.166666666666667
dragon ball z: taiketsu,3,0,0,1,2,6,2.8333333333333335
"turtle beach - ear force dpx21 gaming headset - dolby surround sound - ps3, x360",0,2,1,1,2,6,3.5
from dust [download],0,0,1,3,2,6,4.166666666666667
big city adventure san francisco,0,0,2,1,3,6,4.166666666666667
xbox live arcade unplugged,0,0,0,2,4,6,4.666666666666667
playstation move 14 in 1 pack,0,0,2,0,4,6,4.333333333333333
harry potter and the deathly hallows part 2 - pc,0,0,1,1,4,6,4.5
mystery of mortlake mansion [download],0,0,0,1,5,6,4.833333333333333
final fantasy xiii-2 collector's edition -xbox 360,0,0,0,1,5,6,4.833333333333333
spore - windows xp / vista / mac os x,0,0,0,1,5,6,4.833333333333333
deblob 2 - nintendo wii,0,1,0,2,3,6,4.166666666666667
teenage mutant ninja turtles,0,0,1,2,3,6,4.333333333333333
super dragonball z - playstation 2,1,0,0,3,2,6,3.8333333333333335
disney friends - nintendo ds,0,0,1,2,3,6,4.333333333333333
nyko power pak 360 for xbox 360,0,1,0,1,4,6,4.333333333333333
"limtech 2014 version real 1080p wii to hdmi converter adapter + high speed hdmi cable, 6.5 feet",0,0,0,0,6,6,5.0
dave mirra freestyle bmx 2 - gamecube,0,0,1,3,2,6,4.166666666666667
deblob 2 - playstation 3,0,0,1,2,3,6,4.333333333333333
custom robo arena - nintendo ds,0,0,0,2,4,6,4.666666666666667
rock band 3 wireless fender mustang pro-guitar controller for xbox 360,0,1,0,2,3,6,4.166666666666667
amf bowling pinbusters - nintendo wii,2,2,0,0,2,6,2.6666666666666665
harry potter and the deathly hallows part 1,2,0,1,0,3,6,3.3333333333333335
battlefield 2,0,0,1,2,3,6,4.333333333333333
aliens vs. predator requiem - sony psp,0,1,2,1,2,6,3.6666666666666665
civcity: rome - pc,0,4,0,2,0,6,2.6666666666666665
dsi xl hand grip,0,1,0,1,4,6,4.333333333333333
ultimate ghost 'n goblins - sony psp,0,0,2,1,3,6,4.166666666666667
mx vs atv untamed - nintendo wii,0,0,1,2,3,6,4.333333333333333
tom clancy's ghost recon advanced warfighter 2 - pc,0,2,1,3,0,6,3.1666666666666665
backyard wrestling 2: there goes the neighborhood,2,0,1,0,3,6,3.3333333333333335
godzilla save the earth - xbox,0,0,0,0,6,6,5.0
zoo tycoon 2 - pc,0,0,0,1,5,6,4.833333333333333
rise of flight: the first great air war - iron cross - pc,1,2,1,0,2,6,3.0
dark age of camelot - pc,1,0,3,0,2,6,3.3333333333333335
lego star wars ii: the original trilogy - xbox,0,0,1,1,4,6,4.5
jeep thrills - nintendo wii,0,2,0,2,2,6,3.6666666666666665
batarang wired controller for xbox 360,1,0,0,0,5,6,4.333333333333333
rapalas pro fishing - playstation 2,1,0,0,1,4,6,4.166666666666667
viewtiful joe - playstation 2,0,0,0,2,4,6,4.666666666666667
wwe smackdown vs. raw 2009 - nintendo wii,2,0,2,0,2,6,3.0
"nba live 2004 (ps2, refurb)",0,0,1,3,2,6,4.166666666666667
gamecube controller for nintendo white,0,0,0,2,4,6,4.666666666666667
apache: air assault - xbox 360,0,0,2,1,3,6,4.166666666666667
urbz: sims in the city,0,0,0,1,5,6,4.833333333333333
sony psp battery pack (3.6v - 2400mah) 20% more power,0,0,1,1,4,6,4.5
nancy drew: danger by design - pc,0,0,0,4,2,6,4.333333333333333
dora the explorer: dora saves the mermaids - nintendo ds,0,0,0,0,6,6,5.0
wii incharge dual charge station,0,0,0,2,4,6,4.666666666666667
"atari's greatest hits, volume 2 - nintendo ds",0,0,1,1,4,6,4.5
haunted house - nintendo wii,0,1,1,1,3,6,4.0
ar tonelico: melody of elemia,0,0,0,4,2,6,4.333333333333333
insten compatible with ps2/ps3/ps3 slim hdtv-ready tv hd component av cable 5-wire,2,0,0,0,4,6,3.6666666666666665
guitar hero aerosmith bundle - nintendo wii (wireless bundle),0,0,4,2,0,6,3.3333333333333335
kinetica ps2,0,0,1,2,3,6,4.333333333333333
top shot arcade - nintendo wii,0,0,1,3,2,6,4.166666666666667
xbox 360 sharkoon x-tatic sx stereo gaming headset,0,0,0,3,3,6,4.5
playstation 1 memory card (1 mb),0,0,0,1,5,6,4.833333333333333
nintendo 3ds slide pad dedicated expansion,0,0,1,1,4,6,4.5
the rise of atlantis [download],1,0,1,3,1,6,3.5
ds game card case 24 (yellow),0,0,0,3,3,6,4.5
solatorobo: red the hunter - nintendo ds,0,0,0,0,6,6,5.0
deal or no deal - nintendo ds,0,0,1,3,2,6,4.166666666666667
call of duty: world at war final fronts - playstation 2,0,1,0,2,3,6,4.166666666666667
wii turbo wheel twin pack - 1094,0,0,0,1,5,6,4.833333333333333
kessen ii,1,0,3,1,1,6,3.1666666666666665
self-defense training camp - xbox 360,1,1,2,1,1,6,3.0
zuma's revenge! - nintendo ds,0,0,0,2,4,6,4.666666666666667
deadliest catch: alaskan storm - xbox 360,0,2,2,2,0,6,3.0
frogger: the great quest,2,2,2,0,0,6,2.0
buzz: the mega quiz bundle - playstation 2,0,0,1,1,4,6,4.5
the political machine - pc,1,2,1,2,0,6,2.6666666666666665
psp usb cable,0,0,0,1,5,6,4.833333333333333
gauntlet dark legacy,0,1,2,0,3,6,3.8333333333333335
gemini access universal video game control pad converter,0,0,0,1,5,6,4.833333333333333
hitman trilogy hd premium edition -xbox 360,0,0,0,1,5,6,4.833333333333333
hitman hd trilogy,0,2,1,1,2,6,3.5
duck hunt,0,0,4,0,2,6,3.6666666666666665
tomb raider: underworld,1,0,2,0,3,6,3.6666666666666665
star wars galactic battlegrounds: clone campaigns (expansion pack),0,0,1,3,2,6,4.166666666666667
naruto uzumaki chronicles 2 - playstation 2,0,0,0,1,5,6,4.833333333333333
starter kit for wii u,0,0,0,2,4,6,4.666666666666667
geist - gamecube,0,0,2,2,2,6,4.0
project: snowblind - pc,0,0,3,1,2,6,3.8333333333333335
hde av cable for sega genesis 2 and 3 consoles rca composite audio video cable connection mk-1461 and mk-1631 systems (6 ft),0,0,1,1,4,6,4.5
hde wired infrared sensor bar for nintendo wii,0,0,0,1,5,6,4.833333333333333
madden nfl 07 - nintendo wii,0,1,2,1,2,6,3.6666666666666665
nes/genesis dual action 2-in-1 video game system 16-bit & nes 8-bit games,0,2,0,0,4,6,4.0
diner dash [download],0,0,0,3,3,6,4.5
law & order: dead on the money - pc,3,0,0,1,2,6,2.8333333333333335
"premium vehicle pack - soar, sail, and drive: second life [instant access]",1,1,1,1,2,6,3.3333333333333335
world series baseball (xbox),0,0,0,4,2,6,4.333333333333333
galactic civilizations - pc,0,0,1,4,1,6,4.0
battlestar galactica - xbox,0,0,1,2,3,6,4.333333333333333
madagascar kartz - playstation 3 (game only),1,0,1,0,4,6,4.0
guitar hero: van halen,0,2,2,0,2,6,3.3333333333333335
tom clancy's rainbow six 3: raven shield,0,0,1,3,2,6,4.166666666666667
dewy's adventure - nintendo wii,0,1,1,1,3,6,4.0
brink of consciousness: the lonely hearts murder collector's edition [download],0,0,0,3,3,6,4.5
smuggler's run: warzones - gamecube,0,0,0,3,3,6,4.5
dance dance revolution hottest party - software only - nintendo wii,0,0,2,2,2,6,4.0
dk jungle climber - nintendo ds,0,0,1,1,4,6,4.5
jumper: griffin's story - xbox 360,4,1,0,1,0,6,1.6666666666666667
disney fairies: tinkerbell and the lost treasure,0,0,0,1,5,6,4.833333333333333
nyko pure hd hdmi cable - playstation 3,0,0,1,0,5,6,4.666666666666667
dynasty warriors: gundam 3 - playstation 3,0,3,1,1,1,6,3.0
lords of the realm 3 - pc,4,2,0,0,0,6,1.3333333333333333
csi: crime scene investigation - pc,0,1,2,3,0,6,3.3333333333333335
deca sports 2 - nintendo wii,0,0,0,1,5,6,4.833333333333333
afterglow universal wired headset - blue,1,0,1,2,2,6,3.6666666666666665
naruto shippuden ultimate storm generations - xbox 360,0,0,1,3,2,6,4.166666666666667
madden nfl 10 - playstation 2,0,0,1,2,3,6,4.333333333333333
radica gamester flood light for game boy advance,0,0,0,2,4,6,4.666666666666667
rail simulator - pc,0,4,0,0,2,6,3.0
civilization 3 expansion: play the world - pc,0,0,2,0,4,6,4.333333333333333
arma ii - pc,0,0,1,2,3,6,4.333333333333333
nba live 06 - playstation 2,0,0,2,1,3,6,4.166666666666667
survivor: the interactive game - pc,3,2,1,0,0,6,1.6666666666666667
james bond 007 from russia with love - gamecube,0,1,0,2,3,6,4.166666666666667
i.g.i. 2 covert strike - pc,1,1,2,0,2,6,3.1666666666666665
mad catz officially licensed controller for xbox 360,0,0,1,2,3,6,4.333333333333333
nyko perfect shot for move - playstation 3,1,0,0,0,5,6,4.333333333333333
nds goldeneye rogue agent,1,1,1,1,2,6,3.3333333333333335
caesar iv - pc,0,1,0,3,2,6,4.0
bioshock infinite: ultimate songbird edition - xbox 360,0,0,0,0,6,6,5.0
wii 15-in-1 family pack - white,0,0,1,1,4,6,4.5
the guardian legend,0,0,0,0,6,6,5.0
otogi: myth of demons,0,0,0,3,3,6,4.5
madden nfl 10 - nintendo wii,2,0,0,0,4,6,3.6666666666666665
"samsung ts-h943 replacement dvd drive for xbox 360, ms28 version",0,0,0,2,4,6,4.666666666666667
ps2 lava glow 2.4 ghz rf wireless controller,1,0,2,0,3,6,3.6666666666666665
phantasy star online version 2 - sega dreamcast,1,1,0,1,3,6,3.6666666666666665
".hack: g.u., vol.3: redemption",0,0,0,3,3,6,4.5
replacement rechargeable 3.7v li-ion battery pack for nintendo dsi,1,0,0,0,5,6,4.333333333333333
everquest online adventures,0,2,0,2,2,6,3.6666666666666665
evil dead: a fistful of boomstick,0,1,1,2,2,6,3.8333333333333335
"insten silicone skin case compatible with sony ps3 controller, black",0,1,0,2,3,6,4.166666666666667
ps3 component video cable,0,0,2,0,4,6,4.333333333333333
pro evolution soccer 2010 - playstation 3,0,1,1,0,4,6,4.166666666666667
blitz the league - playstation 2,0,0,1,1,4,6,4.5
"need for speed collection (need for speed underground, need for speed most wanted, need for speed 2)",0,0,1,1,4,6,4.5
karaoke revolution presents: american idol encore bundle - playstation 2,0,0,2,4,0,6,3.6666666666666665
nibiru: age of secrets - pc,0,1,3,1,1,6,3.3333333333333335
magic the gathering: battlegrounds,0,1,0,3,2,6,4.0
super ghouls'n ghosts,0,0,1,1,4,6,4.5
drawn to life,0,0,2,2,2,6,4.0
metal slug 3,0,0,1,3,2,6,4.166666666666667
dragon ball z: ultimate battle 22 - playstation,2,0,1,1,2,6,3.1666666666666665
leisure suit larry: magna cum laude - pc,1,1,0,4,0,6,3.1666666666666665
hunter the reckoning:  wayward - playstation 2,0,1,3,0,2,6,3.5
shrek 2 - gamecube,0,0,1,2,3,6,4.333333333333333
shrek 2 - playstation 2,0,0,0,2,4,6,4.666666666666667
fight night 2004,1,0,1,1,3,6,3.8333333333333335
mysims agents - nintendo ds,0,0,0,1,5,6,4.833333333333333
nintendo ds pokemon platinum version,0,0,0,0,6,6,5.0
power rangers super legends,1,0,0,0,5,6,4.333333333333333
orcs & elves - nintendo ds,2,1,0,2,1,6,2.8333333333333335
xbox 360 wireless halo 3 spartan controller,0,1,1,0,4,6,4.166666666666667
dragon ball z budokai tenkaichi 3,1,1,0,1,3,6,3.6666666666666665
svc chaos - snk vs capcom,1,1,0,2,2,6,3.5
dead space 3: awakened [online game code],0,0,2,1,3,6,4.166666666666667
m&ms kart racing - nintendo wii,2,0,0,2,2,6,3.3333333333333335
xbox 360 sega superstars & live arcade compilation disc,0,0,0,2,4,6,4.666666666666667
murdered: soul suspect [online game code],0,1,2,2,1,6,3.5
ps3 fragfx controller,1,1,1,2,1,6,3.1666666666666665
ride to hell retribution - playstation 3,3,0,0,0,3,6,3.0
geometry wars: galaxies - nintendo wii,0,0,0,1,5,6,4.833333333333333
eye toy play 2 with camera - playstation 2,0,0,0,2,4,6,4.666666666666667
suffering ties that bind - xbox,0,0,2,2,2,6,4.0
power a moga pro mobile gaming system for android smartphones - retail packaging - black,1,0,0,1,4,6,4.166666666666667
soulcalibur: broken destiny - sony psp,0,1,3,0,2,6,3.5
aerobics step platform for wii fit,0,2,0,1,3,6,3.8333333333333335
street fighter iv collector's edition -xbox 360,0,0,2,0,4,6,4.333333333333333
let's yoga - nintendo ds,0,0,0,2,4,6,4.666666666666667
blur - pc,0,0,1,0,5,6,4.666666666666667
guitar hero smash hits - playstation 3,0,0,1,2,3,6,4.333333333333333
jurassic park: operation genesis - pc,0,0,0,4,2,6,4.333333333333333
civilization 3: conquests expansion pack - pc,0,0,0,3,3,6,4.5
monster jam - xbox 360,0,1,1,1,3,6,4.0
adventures of tintin - nintendo wii,1,0,1,1,3,6,3.8333333333333335
terminator 3 rise of the machines - playstation 2,1,1,0,2,2,6,3.5
harvest moon a wonderful life special edition - playstation 2,0,0,2,2,2,6,4.0
final fantasy xi: the vana’diel collection - pc,1,1,0,1,3,6,3.6666666666666665
in the groove - playstation 2,1,0,1,1,3,6,3.8333333333333335
xbox 360 av cable - microsoft oem cable!,0,0,0,0,6,6,5.0
guilty gear x2,0,0,1,2,3,6,4.333333333333333
timesplitters: future perfect,0,0,1,0,5,6,4.666666666666667
assassins creed 2 discovery - nintendo ds,0,0,1,1,4,6,4.5
rise of the argonauts - playstation 3,1,0,1,1,3,6,3.8333333333333335
wii guitar hero 5 guitar bundle,0,0,1,2,3,6,4.333333333333333
"insten 4 port quad charging station with 4 rechargeable 2800 mah battery compatible with nintendo wii remote control dock, white",0,1,0,0,5,6,4.5
the bard's tale,0,0,2,1,3,6,4.166666666666667
iron man - playstation 2,0,2,0,0,4,6,4.0
nfl 2k3 - xbox,0,0,0,3,3,6,4.5
iron man - sony psp,2,0,4,0,0,6,2.3333333333333335
showdown: legends of wrestling,0,0,4,1,1,6,3.5
the spiderwick chronicles - nintendo wii,0,0,0,0,6,6,5.0
50 cent: bulletproof - xbox,2,0,0,1,3,6,3.5
nancy drew: the deadly secret of olde world park - nintendo ds,2,2,1,1,0,6,2.1666666666666665
the elder scrolls iv: oblivion - 5th anniversary edition - xbox 360,0,0,1,1,4,6,4.5
damnation - xbox 360,2,2,1,0,1,6,2.3333333333333335
street fighter iv collector's edition - playstation 3,0,0,0,0,6,6,5.0
golden eye rogue agent - xbox,0,0,1,3,2,6,4.166666666666667
"steel 3.8mm security bit screwdriver tool (7cm length) open cartridges for original nintendo (nes), super nintendo (snes), nintendo 64 (n64), virtual boy, original game boy, game boy color, and sega game gear",0,0,0,0,6,6,5.0
medal of honor limited edition - playstation 3,0,0,1,1,4,6,4.5
tony hawk pro skater 2,1,0,0,0,5,6,4.333333333333333
wheel of fortune ps3,1,0,1,0,4,6,4.0
twisted lands: origin [download],0,0,0,3,3,6,4.5
ps3 master dance pad non-slip,0,2,0,0,4,6,4.0
l.a. noire: the complete edition -xbox 360,0,0,1,1,4,6,4.5
adventures of tintin - playstation 3,0,0,1,0,5,6,4.666666666666667
harvest moon another wonderful life - gamecube,0,0,2,2,2,6,4.0
spore hero - nintendo wii,0,1,3,1,1,6,3.3333333333333335
jeopardy - xbox 360,0,0,0,5,1,6,4.166666666666667
brothers in arms collection,1,1,1,1,2,6,3.3333333333333335
battle fantasia - xbox 360,0,1,2,2,1,6,3.5
electroplankton - nintendo ds,0,0,2,3,1,6,3.8333333333333335
playstation 3 zero wireless controller - colors may vary,1,0,1,3,1,6,3.5
dragonball z sagas - gamecube,0,0,0,2,4,6,4.666666666666667
the borderlands 2 season pass [download],0,0,0,3,3,6,4.5
"fallout collection (fallout, fallout tactics, fallout  a post nuclear rpg)",0,0,3,0,3,6,4.0
csi: 3 dimensions of murder - pc,0,2,0,1,3,6,3.8333333333333335
burnout ngc,1,2,2,1,0,6,2.5
nintendo ds mario kart bundle,0,0,1,0,5,6,4.666666666666667
"gaems g190 halo unsc vanguard personal gaming environment for xbox one s, xbox one, ps4, ps3, xbox 360 (xbox console not included)",1,0,0,0,5,6,4.333333333333333
psp comfort grips black,0,1,0,2,3,6,4.166666666666667
harvest moon: sunshine islands - nintendo ds,0,0,0,1,5,6,4.833333333333333
metal gear acid 2,0,0,0,1,5,6,4.833333333333333
dsi screen protective filter,2,0,0,1,3,6,3.5
astro gaming - a50 wireless headset [2013 model],1,0,2,0,3,6,3.6666666666666665
kingdom of paradise - sony psp,0,0,2,2,2,6,4.0
grand theft auto iv: complete [download],0,0,0,1,5,6,4.833333333333333
bejeweled 3 (with bejeweled blitz live) - xbox 360,0,0,0,1,5,6,4.833333333333333
cradle of egypt 2 - nintendo ds,0,0,0,0,6,6,5.0
lunar legend,0,0,2,1,3,6,4.166666666666667
i spy fun house - nintendo ds,0,2,1,1,2,6,3.5
driver: renegade - nintendo 3ds,1,1,1,2,1,6,3.1666666666666665
call of duty 2: big red one - gamecube,0,1,0,1,4,6,4.333333333333333
the legend of zelda: four swords adventures,0,0,0,1,5,6,4.833333333333333
capcom classics collection remixed - sony psp,0,0,0,0,6,6,5.0
spongebob squarepants the movie - playstation 2,1,1,1,2,1,6,3.1666666666666665
storybook workshop - nintendo wii,0,0,4,2,0,6,3.3333333333333335
tropico 4 gold edition - pc,0,0,3,1,2,6,3.8333333333333335
wii u rainbow stylus pack,0,0,0,1,5,6,4.833333333333333
thrillville: off the rails,0,1,1,1,3,6,4.0
james noir's hollywood crimes,0,0,2,3,1,6,3.8333333333333335
wii & wii fit hands free wrist strap by cta digital,1,1,1,0,3,6,3.5
total control 3 - sega saturn controller/racing wheel connector for dreamcast,0,0,0,2,4,6,4.666666666666667
speed racer: the video game,0,0,2,3,1,6,3.8333333333333335
xbox 360 the beatles: rock band limited edition premium bundle,0,1,0,1,4,6,4.333333333333333
super monkey ball touch & roll - nintendo ds,0,1,4,0,1,6,3.1666666666666665
bastion [download],0,0,1,1,4,6,4.5
second sight - playstation 2,0,0,0,2,4,6,4.666666666666667
devil may cry 4 collector's edition -xbox 360,0,0,0,0,6,6,5.0
crosswords plus - nintendo 3ds,0,0,0,3,3,6,4.5
sold-out software pharaoh gold pharaoh gold,0,0,1,1,4,6,4.5
my chinese coach - nintendo ds,1,0,0,2,3,6,4.0
rondo of swords - nintendo ds,0,3,0,3,0,6,3.0
2 empty standard playstation 3 replacement cases (ps3 replacement cases),1,0,0,0,5,6,4.333333333333333
madden nfl 2003 - pc,0,1,0,3,2,6,4.0
earth & beyond,1,1,1,0,3,6,3.5
tony hawk's pro skater hd [download],1,0,2,2,1,6,3.3333333333333335
rabbids rumble - nintendo 3ds,0,0,0,1,5,6,4.833333333333333
mlb power pros - nintendo wii,0,0,0,1,5,6,4.833333333333333
family feud 2010 edition - nintendo ds,0,1,2,1,2,6,3.6666666666666665
rocksmith guitar and bass - playstation 3,1,0,0,0,5,6,4.333333333333333
final fight one,0,0,1,3,2,6,4.166666666666667
state of emergency - xbox,0,0,4,1,1,6,3.5
hidden relics - pc,0,0,2,0,4,6,4.333333333333333
skylanders giants portal owner pack - xbox 360,0,0,0,1,5,6,4.833333333333333
glory of heracles - nintendo ds,0,0,1,3,2,6,4.166666666666667
the baldur's gate collection (eu),1,0,0,1,4,6,4.166666666666667
guild wars 2 gem card - pc,2,0,2,0,2,6,3.0
mystery dungeon shiren the wanderer - nintendo ds,0,0,0,1,5,6,4.833333333333333
teenage mutant ninja turtles 2 battle nexus - gamecube,0,3,0,1,2,6,3.3333333333333335
crystalis,0,0,0,0,6,6,5.0
dirt - playstation 3,0,0,3,1,2,6,3.8333333333333335
tom clancy's rainbow six vegas 2 limited edition -xbox 360,0,0,0,4,2,6,4.333333333333333
nhl 08 - xbox 360,0,0,0,0,6,6,5.0
"retro-bit nintendo 64 classic usb enabled controller (wired) pc and mac, grey - nintendo 64",0,0,2,1,3,6,4.166666666666667
dynasty warriors 4: empires,1,0,1,2,2,6,3.6666666666666665
mx vs atv reflex - xbox 360,0,1,2,1,2,6,3.6666666666666665
city crisis - playstation 2,2,1,2,0,1,6,2.5
rayman arena ngc,1,0,0,3,2,6,3.8333333333333335
sid meier's civilization v: gods and kings [download],1,0,0,1,4,6,4.166666666666667
x-men: reign of apocalypse,0,0,3,3,0,6,3.5
jumble madness - nintendo ds,0,0,1,2,3,6,4.333333333333333
gameplay snes / gamecube / n64 s-video audio av cable,2,0,0,1,3,6,3.5
mega man network transmission - gamecube,1,0,0,1,4,6,4.166666666666667
leegoal usb charger cable for nintendo 3ds/dsi/dsi xl,0,0,0,2,4,6,4.666666666666667
sid meier's civilization iv special edition - pc,0,1,1,1,3,6,4.0
psp protective filter,1,2,1,0,2,6,3.0
playstation move racing wheel,1,1,0,1,3,6,3.6666666666666665
grand theft auto double pack: grand theft auto iii / grand theft auto vice city - playstation 2,0,0,1,0,5,6,4.666666666666667
dave mirra 2:  freestyle bmx - playstation 2,0,0,0,3,3,6,4.5
me and my katamari - sony psp,0,0,3,1,2,6,3.8333333333333335
ncaa football 2004,0,0,0,0,6,6,5.0
powerup heroes,0,0,3,1,2,6,3.8333333333333335
the simpsons game,0,0,3,1,2,6,3.8333333333333335
the sims 2 holiday edition - pc,2,0,0,2,2,6,3.3333333333333335
at games ultimate portable game player,0,1,0,1,4,6,4.333333333333333
star wars galaxies: starter kit - pc,3,1,0,0,2,6,2.5
"activision skylanders giants triple pack #1: pop fizz, whirlwind, trigger happy",0,0,0,0,6,6,5.0
runaway: a road adventure - pc,1,1,2,1,1,6,3.0
command & conquer red alert 2 expansion: yuri's revenge - pc,0,0,0,0,6,6,5.0
return to castle wolfenstein - platinum edition (includes enemy territory expansion) - pc,1,0,2,1,2,6,3.5
secret of the silver earring - pc,0,0,3,2,1,6,3.6666666666666665
nintendo 3ds retractable metallic touch pen (4 pieces),0,0,1,2,2,5,4.2
cars 2: the video game - nintendo ds,0,0,1,0,4,5,4.6
"jiulyning soft silicone cover case skin for xbox 360 controller camo, 3 color",0,0,0,2,3,5,4.6
"amazon exclusive: skylanders superchargers: fly, dive, drive toy bundle",0,0,0,0,5,5,5.0
ultimate combo pack: god of war collection - playstation 3,0,0,0,0,5,5,5.0
pro evolution soccer 2015 - xbox 360,1,0,2,0,2,5,3.4
ortz® xbox one controller keyboard - 2.4ghz wireless mini bluetooth qwerty keypad adapter for xbox one game controller - best text messenger for xbox one - black,3,1,1,0,0,5,1.6
cta digital nintendo 3ds external power supply and charging dock,1,0,2,0,2,5,3.4
madden nfl 2003,0,0,0,4,1,5,4.2
assetto corsa - xbox one standard edition,3,0,1,1,0,5,2.0
ultimate travel case for dsi xl - blue,0,0,0,1,4,5,4.8
body and brain connection - xbox 360,0,0,0,0,5,5,5.0
wildstar deluxe edition [online game code],1,0,1,2,1,5,3.4
act of war: direct action (dvd) - pc,0,1,1,1,2,5,3.8
bulletstorm [download],0,0,3,1,1,5,3.6
nancy drew: the shattered medallion - multiple (windows and mac): select platform(s),0,0,1,2,2,5,4.2
the smurfs dance party - nintendo wii,0,0,2,1,2,5,4.0
record of agarest war zero standard edition - xbox 360,1,1,1,1,1,5,3.0
ps3 intercooler ts [playstation 3],3,0,1,1,0,5,2.0
air conflicts - xbox 360,0,1,1,1,2,5,3.8
tom clancy's ghost recon advanced warfighter 2 - sony psp,0,0,3,0,2,5,3.8
insten 2 pack gaming chat live headset with microphone compatible with xbox 360 / xbox 360 slim wireless controller m,0,0,1,1,3,5,4.4
playstation 3 160gb call of duty: black ops bundle,0,0,0,0,5,5,5.0
nintendo's legend of zelda series wolf link amiibo,0,0,0,0,5,5,5.0
wii lan adapter,0,0,1,1,3,5,4.4
mother 3 full english translation - made for nintendo game boy advance - homebrew / hack / fan translation [video game] [game boy],0,0,1,0,4,5,4.6
tremorpak plus,1,0,0,3,1,5,3.6
hellgate: london collector's edition - pc,1,1,0,2,1,5,3.2
the sims 4 get together - pc,1,0,0,0,4,5,4.2
rabbids travel in time - nintendo 3ds,0,0,0,2,3,5,4.6
mx vs atv unleashed - xbox,0,0,2,2,1,5,3.8
dream trigger 3d - nintendo 3ds,4,0,0,1,0,5,1.6
nba street homecourt - xbox 360,0,0,0,3,2,5,4.4
farmscapes [download],0,0,0,0,5,5,5.0
jewel match - nintendo ds,0,1,0,2,2,5,4.0
rock band track pk vol2 xbox 360,0,0,1,2,2,5,4.2
pirates of the caribbean: at world's end - xbox 360,1,0,2,0,2,5,3.4
nyko extend link for kinect - xbox 360,0,0,1,1,3,5,4.4
mx vs atv alive - playstation 3,1,0,0,1,3,5,4.0
mx vs atv alive - xbox 360,0,1,0,0,4,5,4.4
dino stalker,0,0,1,0,4,5,4.6
mechassault 2: lone wolf limited edition,0,0,0,2,3,5,4.6
sprung: a game where everyone scores - nintendo ds,2,1,2,0,0,5,2.0
silverfall,0,1,1,2,1,5,3.6
lego ninjago nindroids - nintendo 3ds,0,0,0,2,3,5,4.6
playstation 3 160gb killzone 3 bundle,0,0,1,1,3,5,4.4
mad catz hedgehog inductive charger for wii and wii u,1,0,1,1,2,5,3.6
men in black ii: alien escape,0,1,1,1,2,5,3.8
air conflicts pacific carriers - playstation 4,0,0,1,0,4,5,4.6
deus ex human revolution - augmented edition - playstation 3,0,0,0,1,4,5,4.8
thor: god of thunder - nintendo 3ds,0,0,0,0,5,5,5.0
adventure island ii,0,0,1,1,3,5,4.4
wii messenger bag,0,1,1,1,2,5,3.8
diner dash - nintendo ds,0,1,0,2,2,5,4.0
madden nfl football 3ds,0,0,1,3,1,5,4.0
raving rabbids party collection,0,0,0,0,5,5,5.0
madness extension cable: gray - sega dreamcast,0,0,0,0,5,5,5.0
batman: arkham knight [online game code],1,1,1,1,1,5,3.0
grand theft auto iv - pc download (standard edition) [download],0,1,2,1,1,5,3.4
otogi 2 - xbox,0,0,0,2,3,5,4.6
xbox one 500gb console (certified refurbished),0,2,1,0,2,5,3.4
pac-man championship edition dx [online game code],0,0,0,0,5,5,5.0
digimon world,1,1,0,0,3,5,3.6
pac-man and the ghostly adventures 2 - nintendo 3ds,0,1,1,1,2,5,3.8
generic gray usb charging cable for xbox 360 controllers,1,0,0,0,4,5,4.2
assassin's creed chronicles - playstation vita,0,1,1,1,2,5,3.8
hitman collector's edition - playstation 4,0,0,0,0,5,5,5.0
mario & sonic at the rio 2016 olympic games - nintendo 3ds standard edition,1,0,0,1,3,5,4.0
murder in venice - nintendo ds,0,1,0,2,2,5,4.0
il-2 sturmovik: cliffs of dover - pc,2,0,1,0,2,5,3.0
ps vita 2000 trigger grip - black,2,0,1,1,1,5,2.8
dragon ball z: sagas - xbox,0,1,0,1,3,5,4.2
yu-gi-oh! 5d's world championship 2011 over the nexus - nintendo ds,0,0,0,2,3,5,4.6
warriors orochi 3 ultimate - xbox one,0,1,0,0,4,5,4.4
mlb 15: the show game voucher - playstation vita,1,1,1,1,1,5,3.0
final fantasy xi the ultimate collection - pc,0,0,2,0,3,5,4.2
under night in-birth exe:late - playstation 3,0,0,0,0,5,5,5.0
duck shoot amiibo - japan import (super smash bros series),0,0,0,0,5,5,5.0
"insten wrist strap premium combo compatible with nintendo wii, incldue black / white / light blue / pink",1,0,0,1,3,5,4.0
nintendo mr. game & watch amiibo (super smash bros. collection) for wii u,0,0,0,1,4,5,4.8
help wanted,0,2,0,1,2,5,3.6
glow in dark playstation 3 ps3 wireless game controller anti-slip silicone case skin protector cover (many colors available),0,0,1,0,4,5,4.6
powera charging stand for playstation 4,1,1,0,1,2,5,3.4
the elder scrolls 3: tribunal - morrowind expansion pack,0,0,0,2,3,5,4.6
new play control! donkey kong: jungle beat,0,0,0,4,1,5,4.2
nascar racing 2003 season - pc,0,0,0,0,5,5,5.0
cursed mountain limited edition - nintendo wii,0,1,0,1,3,5,4.2
"resident evil hd remaster biohazard (english, japanese, french, german, italian, spanish) playstation 3",0,0,0,0,5,5,5.0
pure hidden [download],0,0,2,0,3,5,4.2
shaun white skateboarding - playstation 3,0,1,2,0,2,5,3.6
grim grimoire - playstation 2,0,0,1,3,1,5,4.0
army corps of hell - playstation vita,0,0,2,0,3,5,4.2
dead to rights,1,2,1,1,0,5,2.4
"microsoft xbox one wireless controller, (bulk packing)[xbox one]",1,0,1,0,3,5,3.8
dead space,0,0,0,0,5,5,5.0
wasteland 2 - pc,0,3,1,1,0,5,2.6
call of duty: modern warfare 2 prestige edition -xbox 360,0,0,0,0,5,5,5.0
bladestorm: the hundred years' war,0,0,2,1,2,5,4.0
mcbazel hdtv hd av rca component cable cord for xbox 360 / xbox 360 slim,0,0,0,0,5,5,5.0
retro bit universal 3 in 1 ac adapter nes/snes/genesis,0,0,0,1,4,5,4.8
nintendo ds g-pak organizer black,1,0,1,0,3,5,3.8
konami classics volume 1 - xbox 360,0,0,1,0,4,5,4.6
dragon quest monsters: joker,0,1,0,2,2,5,4.0
cta digital wii remote dual charge station with 2 rechargeable batteries (black),1,0,0,0,4,5,4.2
doom ii,0,0,0,1,4,5,4.8
marvel heroes 2016 [download],2,0,2,0,1,5,2.6
new sony playstation 4 20th anniversary edition - ps4300667,2,0,1,0,2,5,3.0
official oem nintendo 3ds ctr-003 rechargeable battery  (not compatiable with  3ds xl),1,0,0,2,2,5,3.8
eve online: the second genesis - pc,1,0,0,0,4,5,4.2
munchables - nintendo wii,0,0,2,3,0,5,3.6
hde battery pack & charger cable for xbox 360 wireless controllers,1,0,0,1,3,5,4.0
microsoft xbox 360 elite 120gb console bundle,2,0,0,0,3,5,3.4
jade cocoon: story of tamamayu - playstation,0,1,0,1,3,5,4.2
crimson gem saga - sony psp,0,0,0,3,2,5,4.4
disney infinity: toy box starter pack (2.0 edition) - playstation 4,0,0,1,0,4,5,4.6
enemy territory: quake wars - playstation 3,0,1,0,1,3,5,4.2
call of duty: advanced warfare - season pass - ps4 [digital code],1,1,0,1,2,5,3.4
teenage mutant ninja turtles: danger of the ooze - playstation 3,1,0,1,1,2,5,3.6
the voice bundle with microphone - wii u,0,0,0,0,5,5,5.0
duck dynasty - playstation 4,4,1,0,0,0,5,1.2
dreamfall game of the year - pc (jewel case),0,0,0,2,3,5,4.6
yoshi's new island full game download code - nintendo 3ds eshop,0,0,1,2,2,5,4.2
harvest moon: the lost valley - nintendo 3ds,1,0,2,0,2,5,3.4
digimon all-star rumble,0,0,2,1,2,5,4.0
dance dance revolution hottest party bundle - nintendo wii,0,0,1,2,2,5,4.2
new nintendo 3ds charging stand white,1,1,1,1,1,5,3.0
avatar - pc,1,0,1,1,2,5,3.6
the sims 3: fast lane stuff - expansion  [download],0,0,1,2,2,5,4.2
wwe smackdown vs. raw 2008 - nintendo wii,3,0,0,0,2,5,2.6
duke nukem: zero hour,0,0,0,1,4,5,4.8
guitar hero smash hits - nintendo wii,0,1,1,2,1,5,3.6
controller gear ps4 controller stand - officially licensed by playstation - black,0,0,0,0,5,5,5.0
fairytale fights - playstation 3,0,1,1,1,2,5,3.8
fairytale fights - xbox 360,0,0,2,2,1,5,3.8
star wars the clone wars: republic heroes - nintendo wii,0,1,2,1,1,5,3.4
gamecube controller connection tap for wii u,0,0,0,0,5,5,5.0
caesar 3 - pc,0,0,1,0,4,5,4.6
battletoads in battlemaniacs,0,0,0,2,3,5,4.6
balloon pop - nintendo ds,2,1,0,0,2,5,2.8
trackir 5 premium head tracking for gaming,0,0,1,1,3,5,4.4
cabela's big game hunter - xbox 360 (game only),0,1,1,1,2,5,3.8
guitar hero 5 stand alone software - playstation 2 (game only),0,0,0,1,4,5,4.8
hot wheels beat that - nintendo wii,0,1,1,1,2,5,3.8
"pdp energizer xbox 360 power & play controller charger with rechargeable battery pack for two wireless controllers charging station, 037-011-na",1,0,0,0,4,5,4.2
myst: masterpiece edition - pc,0,0,0,2,3,5,4.6
grand theft auto v - ps4 [digital code],1,0,1,1,2,5,3.6
super mario maker console deluxe set - nintendo wii u,2,0,0,0,3,5,3.4
real heroes: firefighter - nintendo wii,1,0,2,0,2,5,3.4
global game gear ggg0004 replacement dongle for xbox 360 wired controllers [full retail package],0,0,0,1,4,5,4.8
mission impossible: operation surma,0,1,1,2,1,5,3.6
mini ninjas - nintendo wii,0,0,0,3,2,5,4.4
"insten av composite cable compatible with nintendo 64 n64 / gamecube gc / super nintendo snes, black",0,0,0,0,5,5,5.0
warhammer 40k: squad command - sony psp,0,0,0,4,1,5,4.2
fossil fighters - nintendo ds,0,1,0,3,1,5,3.8
nintendo 2ds handheld system with mario kart 7 - electric blue,1,0,0,0,4,5,4.2
post mortem - pc,0,0,1,1,3,5,4.4
darkness within: in pursuit of loath nolder - pc,0,0,1,1,3,5,4.4
monster hunter 4 ultimate collector's edition - nintendo 3ds,0,0,0,0,5,5,5.0
cta digital wii knockout boxing gloves,0,0,1,0,4,5,4.6
horse life - nintendo wii,0,1,0,0,4,5,4.4
quake ii,0,0,0,4,1,5,4.2
us backlight lcd screen replacement for psp 1000 1001,0,0,1,1,3,5,4.4
neverwinter nights: shadow of undrentide expansion pack - pc,0,1,1,2,1,5,3.6
soul calibur legends,2,2,0,1,0,5,2.0
wii fit,0,0,0,0,5,5,5.0
just cause 2 ps3,0,0,0,2,3,5,4.6
supreme commander 2 - xbox 360,0,0,1,1,3,5,4.4
marvel super hero squad,1,1,0,1,2,5,3.4
spongebob truth or square - nintendo wii,0,0,0,3,2,5,4.4
women's murder club games of passion - nintendo ds,0,1,2,0,2,5,3.6
captain america and the avengers,0,0,0,1,4,5,4.8
amplitude - playstation 2,0,0,0,1,4,5,4.8
wii fighting stick,0,1,1,2,1,5,3.6
need for speed rivals (complete edition) - xbox 360,0,0,1,0,4,5,4.6
playstation vita wi-fi model aqua blue (pch-2000za23) japanese ver. japan import,0,0,0,1,4,5,4.8
infinite space - nintendo ds,0,1,1,1,2,5,3.8
bd&a skylanders trap storage,0,0,0,0,5,5,5.0
wwii aces - nintendo wii,0,0,2,0,3,5,4.2
mahjong: journey quest for tikal - nintendo ds,0,0,1,0,4,5,4.6
nintendo dsi car adapter,0,0,0,2,3,5,4.6
fifa 15 - wii,1,0,0,1,3,5,4.0
naruto shipuden: ultimate ninja heroes 3 - sony psp,1,0,0,1,3,5,4.0
mortimer beckett and the time paradox [download],0,0,1,1,3,5,4.4
agatha christie 4:50 from paddington [download],0,0,0,2,3,5,4.6
mortal kombat x: kollector's edition - playstation 4,0,0,0,0,5,5,5.0
hidden expedition: everest - pc,0,0,0,3,2,5,4.4
gamecube wii max memory card 123 blocks,0,0,0,0,5,5,5.0
langrisser re: incarnation - tensei - nintendo 3ds,1,2,0,1,1,5,2.8
need for speed: porsche unleashed - pc,0,0,1,3,1,5,4.0
ys: the ark of napishtim,0,0,0,2,3,5,4.6
tony hawk: shred bundle - playstation 3 (skateboard bundle),1,0,1,0,3,5,3.8
who wants to be a millionaire? - nintendo ds,0,0,2,0,3,5,4.2
rapala pro bass fishing 2010 - xbox 360,0,0,2,2,1,5,3.8
dead or alive 4 platinum hits,0,2,2,0,1,5,3.0
"insten® car charger compatible with nintendo ds lite, black",0,0,1,0,4,5,4.6
dragon age 2 - bioware signature edition - playstation 3,0,0,1,1,3,5,4.4
hks racing controller - playstation 3,1,0,0,0,4,5,4.2
move champions pack - playstation 3,0,0,0,2,3,5,4.6
nintendo ds lite g-pak organizer coral pink,0,0,1,3,1,5,4.0
princess isabella - a witch's curse - nintendo ds,0,1,2,1,1,5,3.4
250gb hard disk drive for xbox 360,1,0,1,0,3,5,3.8
classic games for the atari 2600,1,0,0,1,3,5,4.0
simcity 2000,0,3,1,0,1,5,2.8
saga frontier 2,1,0,0,1,3,5,4.0
road rash,0,0,0,2,3,5,4.6
playstation 3 monster cable gamelink hdmi digital video/audio cable,0,0,0,2,3,5,4.6
the great tree [download],0,0,2,2,1,5,3.8
final fantasy fables: chocobo tales - nintendo ds,0,0,1,2,2,5,4.2
tony hawk pro skater 4 - gamecube,0,0,0,2,3,5,4.6
the experiment - pc,0,0,0,3,2,5,4.4
dying light season pass - xbox one digital code,0,0,0,0,5,5,5.0
the lord of the rings: mines of moria - pc,0,0,0,0,5,5,5.0
spyro 2: season of flame,1,0,0,0,4,5,4.2
dsi pikachu charge stand,0,1,3,1,0,5,3.0
i spy spooky mansion - nintendo wii,0,0,3,1,1,5,3.6
ben 10: protector of earth - nintendo wii,0,1,1,2,1,5,3.6
ben 10 protector of earth,0,0,0,0,5,5,5.0
ps3 playstation move energizer 2x power charging system,0,0,0,2,3,5,4.6
collective minds 8 pack metal stylus set,0,0,1,2,2,5,4.2
assassin's creed unity collector's edition - xbox one,0,0,1,0,4,5,4.6
raiden 3 - playstation 2,0,1,1,0,3,5,4.0
thrustmaster t-flight stick x ps3,0,0,1,3,1,5,4.0
drawn to life collection - nintendo ds,0,0,0,0,5,5,5.0
lego marvel's avengers - xbox 360,0,0,1,2,2,5,4.2
sniper elite iii [online game code],0,0,1,2,2,5,4.2
hyperdimension neptunia re;birth1 limited edition [video game],1,0,1,0,3,5,3.8
monster jam: path of destruction with custom wheel - playstation,0,0,1,2,2,5,4.2
command & conquer red alert 3 - playstation 3,0,0,0,1,4,5,4.8
shrek the third - nintendo wii,1,1,0,1,2,5,3.4
udraw: dood's big adventure,0,1,1,1,2,5,3.8
pictionary - udraw - nintendo wii,0,1,0,2,2,5,4.0
peggle nights - pc,0,0,0,0,5,5,5.0
paper mario - wii u [digital code],0,0,0,0,5,5,5.0
the golf club: collector's edition - xbox one,1,0,0,1,3,5,4.0
dynasty warriors 6: empires - playstation 3,1,0,1,1,2,5,3.6
playstation portable limited edition ratchet & clank entertainment pack - piano black,0,1,0,2,2,5,4.0
disney infinity: marvel super heroes (2.0 edition) power disc pack,0,0,0,0,5,5,5.0
interact superpad 64 controller,2,1,1,0,1,5,2.4
stuntman: ignition - xbox 360,0,1,0,4,0,5,3.6
samurai warriors 3 - nintendo wii,0,0,1,1,3,5,4.4
overwatch - collector's edition - xbox one,0,0,1,0,4,5,4.6
return to mysterious island - pc,0,0,1,3,1,5,4.0
i spy universe - nintendo ds,0,1,0,0,4,5,4.4
harry potter and the order of the phoenix - pc,1,0,2,2,0,5,3.0
star wars jedi knight ii: jedi outcast,0,0,1,1,3,5,4.4
the witch and the hundred knight: revival edition - playstation 4,0,0,0,1,4,5,4.8
trillion: god of destruction - playstation vita,0,0,1,3,1,5,4.0
destiny - expansion pass - playstation 3 [digital code],0,0,0,0,5,5,5.0
kontrolfreek cqc - xbox one,0,0,0,2,3,5,4.6
kirby's avalanche,2,0,0,1,2,5,3.2
singstar queen - stand alone - playstation 2,0,0,0,1,4,5,4.8
dirt - pc,0,1,2,1,1,5,3.4
new intercooler cooling fan for sony playstation 3 ps3,0,0,2,0,3,5,4.2
unreal tournament 2004 (editor's choice edition),0,0,0,2,3,5,4.6
"insten clear white silicone skin case compatible with sony psp 3000, clear white",1,1,1,1,1,5,3.0
uru: ages beyond myst - pc,0,0,2,0,3,5,4.2
sins of a solar empire: trinity mbx,1,0,0,1,3,5,4.0
100 classic books - nintendo ds,1,0,0,0,4,5,4.2
modnation racers - sony psp,0,0,0,1,4,5,4.8
kid adventures: sky captain - nintendo wii,0,2,0,1,2,5,3.6
overwatch - collector's edition - playstation 4,0,0,0,0,5,5,5.0
a.c.e.: another century's episode r for playstation 3 (japanese language import),0,0,0,1,4,5,4.8
hasbro family game night 3 - xbox 360,0,1,0,2,2,5,4.0
nascar kart racing - nintendo wii,0,1,0,2,2,5,4.0
collective minds cronusmaxplus with bt dongle & sound card - playstation 4,1,0,0,0,4,5,4.2
rock band drum set - playstation 2/playstation 3,0,0,0,0,5,5,5.0
ps3 homefront,2,2,0,0,1,5,2.2
the sims 2 deluxe (sims 2 and sims nightlife expansion) - pc,0,0,1,0,4,5,4.6
king's bounty: armored princess - free demo [download],3,0,1,0,1,5,2.2
nes/snes/genesis fc3 plus gaming system,2,0,1,0,2,5,3.0
harry potter and the deathly hallows part 1 - playstation 3,2,0,1,0,2,5,3.0
dsi xl silicone sleeve - clear,0,0,1,0,4,5,4.6
frogger,0,0,1,0,4,5,4.6
ea sports ufc 2 - xbox one,2,1,0,0,2,5,2.8
harry potter and the order of the phoenix - playstation 2,1,0,0,1,3,5,4.0
super pad entertainment joypad,0,0,1,0,4,5,4.6
are you smarter than a 5th grader: back to school - nintendo wii,0,1,0,0,4,5,4.4
burger shop [download],1,0,1,1,2,5,3.6
world of warcraft: legion - collector's edition - pc/mac,1,0,0,1,3,5,4.0
virtual villagers [download],0,0,2,3,0,5,3.6
whacked,0,1,1,1,2,5,3.8
hori hard case for playstation vita 2000 and 1000 series,0,0,0,2,3,5,4.6
up - nintendo wii,0,0,0,3,2,5,4.4
silent hill 4: the room - pc,1,0,0,2,2,5,3.8
smaacc dual-channel charging station for ps4 controller/dualshock 4 wireless controller,0,0,0,0,5,5,5.0
"guitar hero 3-disc set with guitar hero i, guitar hero ii and guitar hero 80's encore - playstation 2",0,0,0,1,4,5,4.8
nintendo e-reader - card reader for game boy advance,1,0,2,0,2,5,3.4
blazing angels squadrons of wwii,0,0,0,1,4,5,4.8
tomee 256kb memory pak for n64,0,0,0,2,3,5,4.6
dead or alive 3 platinum hits,0,0,1,2,2,5,4.2
rome total war: barbarian invasion expansion pack - pc,0,0,1,1,3,5,4.4
nascar thunder 2002,0,0,0,1,4,5,4.8
mega man battle network 5 - nintendo ds,0,0,0,1,4,5,4.8
scarface money power respect - sony psp,2,1,0,1,1,5,2.6
spongebob squarepants the battle for bikini bottom - xbox,0,0,1,2,2,5,4.2
black replacement kit xbox 360 controller shell + button parts,0,1,0,0,4,5,4.4
nba jam,1,0,0,1,3,5,4.0
star trek deep space nine: dominion wars - pc,0,0,1,3,1,5,4.0
battleship ps3,0,1,0,1,3,5,4.2
gameboy advance sp gameshark game codes,1,0,1,1,2,5,3.6
lemmings - sony psp,0,0,0,3,2,5,4.4
turtle beach ear force dss2 dolby surround sound processor - xbox 360,0,1,0,0,4,5,4.4
forza horizon 3 - xbox one/windows 10 [digital code],1,0,1,1,2,5,3.6
rugrats in paris: the movie,0,0,2,1,2,5,4.0
popolocrois - sony psp,0,0,1,2,2,5,4.2
open season - xbox 360,0,0,1,1,3,5,4.4
sid meier's civilization v,1,2,0,0,2,5,3.0
king's quest collection,0,1,0,2,2,5,4.0
samurai warriors 4-ii - playstation 4,0,0,0,1,4,5,4.8
lego star wars ii: the original trilogy,0,0,0,2,3,5,4.6
fifa 2001: major league soccer,1,0,2,1,1,5,3.2
gears of war 4 - ultimate edition - xbox one/windows 10 [digital code],0,1,0,1,3,5,4.2
mystical ninja starring goemon,0,0,0,1,4,5,4.8
broken sword: shadow of the templars - nintendo ds,0,0,0,1,4,5,4.8
azurik: rise of perathia,2,0,1,1,1,5,2.8
delta force 2 - pc,0,0,1,3,1,5,4.0
sega 48-game mega arcade pack [online game code],0,0,0,1,4,5,4.8
midtown madness 2 - pc,0,1,0,2,2,5,4.0
007 the world is not enough ps,0,0,1,1,3,5,4.4
hot wheels world's best driver - xbox 360 standard edition,2,0,0,0,3,5,3.4
funky barn - nintendo 3ds,0,0,2,1,2,5,4.0
star wars knights of the old republic collection (i & ii bundle),1,0,1,2,1,5,3.4
xbox 360 energizer power & play charging system w/ x2 battery pack (colors may vary),1,0,1,1,2,5,3.6
u.s. army universal gaming headset with 3d effect for ps3/xbox/pc,0,1,0,0,4,5,4.4
red orchestra: ostfront 41-45 - pc,1,0,1,2,1,5,3.4
evil genius - pc,0,0,0,2,3,5,4.6
nyko universal power cord - replacement power cord for playstation 4 and playstation 4 slim,0,0,0,2,3,5,4.6
nhl 2001 - pc,0,0,0,0,5,5,5.0
tnti™ arc charger - playstation 4 dualshock controller charger with ac adapter ps4 pro and slim compatible,0,0,1,1,3,5,4.4
spongebob squarepants: supersponge,0,0,0,1,4,5,4.8
fallout 4: far harbor - ps4 [digital code],1,0,1,1,2,5,3.6
guitar hero rechargeable battery pack kit for wireless guitars,2,0,2,1,0,5,2.4
nintendo 3ds multi travel pouch - black,0,0,2,1,2,5,4.0
xcom: enemy within,0,0,1,0,4,5,4.6
dreamgear playstation vita 7 in 1 starter kit,0,0,1,1,3,5,4.4
dreamgear 4 in 1 case bundle for playstation vita (model pch-1000),0,0,1,2,2,5,4.2
playstation 2 dual shock controller black,1,0,0,0,4,5,4.2
tony hawk's pro skater 3,0,0,0,1,4,5,4.8
hori xbox 360 gem pad ex - ruby red,0,1,3,0,1,5,3.2
ssx tricky,0,0,0,1,4,5,4.8
skylanders: giants glow in the dark sonic boom,0,1,0,0,4,5,4.4
guitar hero 1 and 2 (game only) - playstation 2,0,0,0,0,5,5,5.0
norn9: var commons - playstation vita,0,0,0,1,4,5,4.8
wwe smackdown vs. raw 2009 - sony psp,0,0,0,4,1,5,4.2
jewel master: cradle of egypt 2 - nintendo 3ds,0,0,1,1,3,5,4.4
cars 2 - sony psp,0,0,0,0,5,5,5.0
army men - sarge's heroes 2,0,0,1,2,2,5,4.2
warframe [download],1,0,0,0,4,5,4.2
farming simulator - xbox 360,0,0,1,0,4,5,4.6
sony computer entertainment hdmi cable - playstation 3,0,0,0,0,5,5,5.0
mafia iii deluxe edition - xbox one,0,0,1,0,4,5,4.6
psp ac adapter,0,0,0,1,4,5,4.8
spider-man 2 - sony psp,0,0,0,1,4,5,4.8
nba 2k17 - early tip off edition - xbox one,1,0,0,0,4,5,4.2
rpg maker,0,0,1,1,3,5,4.4
batman: rise of sin tzu - playstation 2,1,1,1,1,1,5,3.0
deadliest catch: alaskan storm - pc,0,0,2,2,1,5,3.8
dora the explorer: journey to the purple planet - playstation 2,0,0,0,0,5,5,5.0
gothic 2 gold - pc,3,0,0,1,1,5,2.4
gamemaster sony ps vita anti-bacterial screen protector,0,1,1,0,3,5,4.0
import tuner challenge - xbox 360,0,0,2,0,3,5,4.2
call of duty: modern warfare 3 limited edition wireless controller,0,0,1,1,3,5,4.4
tomee universal charge kit for new 2ds xl/ new 3ds/ new 3ds xl/ 2ds/ 3ds xl/ 3ds/ dsi xl/ dsi/ ds lite,0,0,0,0,5,5,5.0
desperate housewives - pc,1,0,1,2,1,5,3.4
deus ex: human revolution - director's cut [online game code],0,0,0,0,5,5,5.0
fist of the north star: ken's rage 2 - xbox 360,0,0,2,2,1,5,3.8
scarface the world is yours - pc,0,1,1,1,2,5,3.8
exclusive skylanders spyro's adventure gill grunt variant translucent green,0,0,0,1,4,5,4.8
guitar hero sg controller - black - playstation 2,0,0,1,1,3,5,4.4
"damage inc., pacific squadron wwii - xbox 360",0,0,2,2,1,5,3.8
dungeon siege 2: broken world expansion pack - pc,0,1,0,3,1,5,3.8
catwoman - playstation 2,1,2,0,0,2,5,3.0
frozen: olaf's quest - nintendo ds,1,0,0,0,4,5,4.2
"guild wars 2, heart of thorns - pc guild wars 2, heart of thorns edition",1,2,0,0,2,5,3.0
jack the ripper - pc,0,2,0,2,1,5,3.4
amber: journeys beyond (jewel case) - pc,0,0,1,3,1,5,4.0
xbox wireless network adapter mn740,0,0,0,0,5,5,5.0
mysterious journey 2,2,1,1,1,0,5,2.2
avatar - gamecube,0,0,0,1,4,5,4.8
red wii mini console motionplus bundle (wii),3,0,0,0,2,5,2.6
dynasty warriors - sony psp,0,1,3,0,1,5,3.2
puzzle quest galactrix - nintendo ds,0,0,2,2,1,5,3.8
phantasy star online episode iii: c.a.r.d. revolution,0,0,0,1,4,5,4.8
borderlands 2 game of the year [download],0,0,0,0,5,5,5.0
carmageddon: max damage - playstation 4,0,0,2,1,2,5,4.0
carmageddon: max damage - xbox one,1,1,1,2,0,5,2.8
super nintendo nes system - mini redesign,0,0,0,1,4,5,4.8
majesty gold - pc,0,0,0,0,5,5,5.0
disney infinity 3.0: star wars sabine wren figure (ps4/ps3/xbox 360/xbox one/nintendo wii u),0,0,0,0,5,5,5.0
nintendo ds lite car adapter,0,1,0,0,4,5,4.4
europa universalis 2 - pc,1,0,0,1,3,5,4.0
tom clancy's ghost recon wildlands (gold edition) - playstation 4,0,0,1,0,4,5,4.6
persona 4 arena - xbox 360,0,0,0,1,4,5,4.8
skylanders swap force - legendary free ranger,0,0,0,0,5,5,5.0
tom clancy's ghost recon wildlands (deluxe edition) - playstation 4,0,0,1,1,3,5,4.4
persona 2: eternal punishment - playstation,0,0,1,1,3,5,4.4
razer atrox for xbox one: fully mod-capable - sanwa joystick and buttons - internal storage compartment - tournament arcade stick for xbox one,1,0,0,2,2,5,3.8
wall-e - sony psp,0,0,2,0,3,5,4.2
shrek superslam - playstation 2,1,0,0,1,3,5,4.0
"popcap arcade vol. 1 (bejeweled 2, astro pop, feeding frenzy, zuma)",0,0,2,0,3,5,4.2
scribblenauts unlimited - pc,0,1,1,0,3,5,4.0
skylanders spyro's adventure: drill sergeant (clear red limited edition),0,0,1,0,4,5,4.6
6 pak,0,0,0,0,5,5,5.0
funky barn - nintendo wii u,0,0,1,1,3,5,4.4
company of heroes 2 - pc,0,2,0,1,2,5,3.6
world of tanks [download],0,0,2,1,2,5,4.0
armored core: verdict day - playstation 3,0,0,0,1,4,5,4.8
rock band 4 - playstation 4,0,0,0,3,2,5,4.4
ice age 2: the meltdown - playstation 2,0,0,0,1,4,5,4.8
the legend of spyro: a new beginning,0,1,0,0,4,5,4.4
xgiii extreme g racing,0,0,0,3,2,5,4.4
monster lab - nintendo wii,0,0,1,0,4,5,4.6
heroes of the pacific - playstation 2,1,0,0,2,2,5,3.8
watch dogs 2: deluxe edition (includes extra content) - xbox one,1,0,0,0,4,5,4.2
naruto shippuden: ultimate storm 3 full burst - playstation 3,0,0,0,1,4,5,4.8
pro evolution soccer 2014 - xbox 360,2,0,1,1,1,5,2.8
thq destroy all humans! path of the furon for xbox 360,1,0,0,2,2,5,3.8
gundam: journey to jaburo,1,1,1,0,2,5,3.2
wall-e - playstation 3,0,0,0,0,5,5,5.0
over g fighters (xbox 360),0,2,1,1,1,5,3.2
stubbs the zombie in rebel without a pulse - pc,2,0,0,1,2,5,3.2
sky odyssey,0,0,1,3,1,5,4.0
nancy drew: the deadly device,0,0,0,2,3,5,4.6
pac 'n roll,0,0,0,2,3,5,4.6
true swing golf - nintendo ds,0,0,2,2,1,5,3.8
saitek playstation 2 dvd remote control,2,2,1,0,0,5,1.8
oni - pc,0,1,1,1,2,5,3.8
activision anthology,0,0,0,1,4,5,4.8
snoopy's grand adventure - playstation 4,0,0,0,3,2,5,4.4
gameboy advance link cable,2,0,0,0,3,5,3.4
logitech cordless vantage headset for playstation 3,0,0,1,2,2,5,4.2
strawberry shortcake: sweet dreams game - playstation 2,0,0,1,2,2,5,4.2
f1 race stars,0,1,0,0,4,5,4.4
pdp spinning fire bar display - nintendo wii u,0,0,0,0,5,5,5.0
heroes of might & magic 3 complete - pc,0,0,0,0,5,5,5.0
"activision skylanders giants triple pack #5 (prism break, lightning rod & drill sergeant)",0,0,0,0,5,5,5.0
gamecube controller - spice orange,0,0,0,0,5,5,5.0
rock candy wii control stick - blue,0,0,1,1,3,5,4.4
tales of zestiria: collector's edition - playstation 4,0,0,0,1,4,5,4.8
richard burns rally,1,0,1,1,2,5,3.6
microsoft flight simulator 2002 standard - pc,1,0,0,3,1,5,3.6
falcon 4.0: allied force - pc,0,0,0,1,4,5,4.8
family party 30 great games: obstacle arcade - nintendo wii u,4,0,1,0,0,5,1.4
microsoft flight simulator 2002 professional - pc,0,1,1,1,2,5,3.8
minecraft,0,0,0,2,3,5,4.6
steambot chronicles - playstation 2,0,1,1,2,1,5,3.6
vga monitor high definition cable rca sound adapter for sega dreamcast,0,1,0,0,4,5,4.4
f1 2016 - playstation 4,1,0,0,0,4,5,4.2
theme park roller coaster,0,1,1,1,2,5,3.8
oem chrome silver/gray transforming d-pad for xbox 360 controller (rotating),1,0,0,0,4,5,4.2
yu yu hakusho dark tournament - playstation 2,0,0,0,2,3,5,4.6
banjo-kazooie: grunty's revenge,0,0,0,3,2,5,4.4
the sims 4 spa day [online game code],0,1,1,0,3,5,4.0
ncaa football 06,0,0,3,0,2,5,3.8
nfl street - xbox,0,0,0,5,0,5,4.0
playstation move essentials bundle: just dance 3,0,0,0,0,5,5,5.0
skylanders spyro's adventure character pack legendary trigger happy,0,0,0,1,4,5,4.8
zoo tycoon 2,0,0,2,1,2,5,4.0
hde 16-in-1 game card travel case protective storage holder organizer for nintendo 3ds and ds cartridges,0,1,1,0,3,5,4.0
tera online collector's edition - pc,1,0,0,0,4,5,4.2
playstation 2 bundle - family,0,0,2,2,1,5,3.8
sid meier's civilization ii (jewel case),0,1,0,0,4,5,4.4
disney infinity 3.0 edition: disneypixar's disgust figure,0,0,0,0,5,5,5.0
freespace 2,0,0,1,1,3,5,4.4
incredible crisis,1,0,2,2,0,5,3.0
test drive: eve of destruction,0,0,1,1,3,5,4.4
syphon filter 3 - playstation,1,0,0,0,4,5,4.2
black & white 2: battle of gods expansion pack - pc,0,0,0,0,5,5,5.0
"turtle beach - i60 premium wireless gaming headset - dts headphone:x 7.1 surround sound - mac, pc",0,0,0,2,3,5,4.6
cabela's dangerous hunts - playstation 2,0,0,0,1,4,5,4.8
kmd 3000mah rechargeable battery pack for nintendo wii u internal controller,1,1,1,0,2,5,3.2
transformers prime: the game - nintendo 3ds,0,0,0,0,5,5,5.0
nba ballers: chosen one - playstation 3,0,0,0,0,5,5,5.0
watch dogs: limited edition,0,0,1,2,2,5,4.2
gigaware universal gaming component cable with switch 26-1542,0,0,0,0,5,5,5.0
snk arcade classics vol 1 - sony psp,0,0,1,2,2,5,4.2
xcom 2 - xbox one,1,0,0,2,2,5,3.8
far cry (jewel case) - pc,1,0,0,0,4,5,4.2
pro evolution soccer 2013,0,0,1,0,4,5,4.6
sea dogs - pc,0,1,1,0,3,5,4.0
angry birds star wars - playstation vita,0,0,1,0,4,5,4.6
nba 2k2,0,0,0,1,4,5,4.8
madden nfl 08 [download],1,0,0,4,0,5,3.4
psychonauts [download],0,0,0,1,4,5,4.8
skylanders imaginators - wii u,1,0,0,1,3,5,4.0
"nba live 2001 (ps2, refurb) [playstation2] [playstation2] [playstation2]",0,1,2,1,1,5,3.4
atv offroad fury 3 - playstation 2,0,0,1,2,2,5,4.2
assassin's creed iv: black flag - limited edition,1,0,0,0,4,5,4.2
wwe 2k17 - xbox 360,2,0,1,1,1,5,2.8
polk audio melee headphone - blue - xbox/xbox 360,0,0,1,0,4,5,4.6
spongebob squarepants: plankton's robotic revenge - xbox 360,0,1,2,1,1,5,3.4
blazing angels: squadrons of wwii - pc,0,0,1,1,3,5,4.4
time crisis 3,0,0,1,2,2,5,4.2
nba 2k17- legends gold - xbox one,0,0,0,1,4,5,4.8
saints row iv - game of the generation edition -xbox 360,1,0,0,1,3,5,4.0
urban chaos riot response - playstation 2,0,0,0,1,4,5,4.8
sceneit? includes 4 big button gamepads - xbox 360,0,0,1,3,1,5,4.0
half life 2 - pc,0,0,0,0,5,5,5.0
street fighter alpha 2,0,0,1,1,3,5,4.4
cirka controller for n64 (turquoise),0,0,0,1,4,5,4.8
universal microphone stand,0,0,1,1,3,5,4.4
dynasty warriors 8 - playstation 3,0,0,0,1,4,5,4.8
alice: madness returns [online game code],0,2,0,3,0,5,3.2
shaun white snowboarding - playstation 3,1,0,2,0,2,5,3.4
tony hawk american wasteland - gamecube,0,0,2,1,2,5,4.0
kinect privacy shield for xbox one by foamy lizard ® kinect 2.0 glossy black protective concealing camera and lens cover for xbox one console sensor,0,0,1,0,4,5,4.6
geometry wars: galaxies - nintendo ds,0,1,0,0,4,5,4.4
sony playstation s-video cable,0,0,0,2,3,5,4.6
turtle beach ear force playstation 4 talkback cable with foam windscreen,0,0,0,1,4,5,4.8
motionsports: adrenaline - playstation 3,0,1,1,1,2,5,3.8
mobile suit gundam: crossfire - playstation 3,2,1,2,0,0,5,2.0
saga frontier,1,0,0,1,3,5,4.0
gameboy advance plastic game cases - 10 count,0,0,0,0,5,5,5.0
silent hunter: wolves of the pacific gold edition - pc,0,0,0,2,3,5,4.6
nightmares from the deep [download],0,0,1,1,3,5,4.4
high heat baseball 2002,0,0,1,4,0,5,3.8
murder in the abbey - pc,0,2,3,0,0,5,2.6
whisper fan 360 green,0,0,1,2,2,5,4.2
princess debut - nintendo ds,0,0,0,1,4,5,4.8
ps3 versus controller,0,1,2,0,2,5,3.6
1080° avalanche,0,0,1,0,4,5,4.6
midnight mysteries 3: devil on the mississippi - pc,0,0,2,0,3,5,4.2
nintendo falco amiibo - wii u,0,0,0,0,5,5,5.0
full parts replacement housing shell pack for nintendo gameboy advance sp gba sp(dark blue)(battery is not included),1,0,0,1,3,5,4.0
donkey kong,0,0,4,0,1,5,3.4
elder scrolls online: imperial edition,0,0,0,2,3,5,4.6
bandfuse: rock legends (artist pack),1,0,1,0,3,5,3.8
pro pack mini plus controller set for wii - black,0,0,0,3,2,5,4.4
xbox live 24 month gold membership - xbox 360 digital code,0,0,1,0,4,5,4.6
roy amiibo (super smash bros series),0,0,1,0,4,5,4.6
ben 10 alien force - nintendo wii (jewel case),0,0,1,1,3,5,4.4
fifa soccer 09 - xbox 360,0,0,0,1,4,5,4.8
disney infinity phineas,0,0,0,1,4,5,4.8
aura: fate of the ages - pc,1,1,1,2,0,5,2.8
nintendo entertainment system action set,0,0,0,1,4,5,4.8
bug - sega saturn,0,0,1,0,4,5,4.6
master of orion 3 - pc,1,2,2,0,0,5,2.2
lord of the rings: conquest - nintendo ds,0,0,1,1,3,5,4.4
ps4 console designer skin for sony playstation 4 system plus two(2) decals for: ps4 dualshock controller - battle torn stripes,0,0,1,0,4,5,4.6
"skylanders spyro's adventure triple character pack (prism break, boomer, voodood)",0,0,0,0,5,5,5.0
pdp disney infinity base protector,0,0,1,1,3,5,4.4
skate it - nintendo wii,0,0,2,0,3,5,4.2
nes max pad,0,1,1,1,2,5,3.8
the incredible hulk - nintendo wii,2,1,2,0,0,5,2.0
animal crossing card amiibo [animal crossing series] 5 pack set,0,0,0,1,4,5,4.8
tiger woods pga tour 12: the masters - pc/mac,3,2,0,0,0,5,1.4
kmd xbox 360 progamer analog thumb grips,0,0,0,1,4,5,4.8
dungeon siege 3 - demo [download],1,1,0,1,2,5,3.4
dungeon siege 3 [online game code],0,0,1,1,3,5,4.4
bandfuse: rock legends (artist pack),2,0,0,1,2,5,3.2
"tomee ""moonlight"" n64 usb controller for pc/ mac (clear blue)",0,0,0,1,4,5,4.8
gt pro series (with wheel) - nintendo wii,1,0,0,2,2,5,3.8
battlefield 4 - pc,1,0,1,1,2,5,3.6
disgaea 4: a promise revisited - playstation vita standard edition,0,0,0,0,5,5,5.0
mini pro ex wired controller for xbox 360 - green,0,1,0,1,3,5,4.2
call of duty: black ops ii care package,0,0,1,0,4,5,4.6
donop® 2.4g wireless game pad joysticks gaming controller joypad gamepad console for sony playstation 2 ps2 w/ dual shock dual includes donop® black silicone wristband,0,0,0,2,3,5,4.6
mad catz dream pad - sega dreamcast,0,0,0,3,2,5,4.4
call of duty: black ops ii [care package] - playstation 3,1,0,1,1,2,5,3.6
gamecube console - legend of zelda bundle - black,0,0,0,2,3,5,4.6
super dodge ball advance,0,0,1,1,3,5,4.4
big fish: sable maze 1: sullivan river and sable maze 2: norwich caves - pc,0,0,1,0,4,5,4.6
bioshock infinite season pass [download],0,0,1,0,4,5,4.6
smash court tennis 2 - playstation 2,0,0,1,2,2,5,4.2
the hardy boys: the hidden theft - pc,1,1,1,0,2,5,3.2
nba street v3 - gamecube,0,0,0,1,4,5,4.8
guilty gear xx accent core - playstation 2,0,0,1,2,2,5,4.2
vanguard saga of heroes - pc,1,2,0,2,0,5,2.6
skylanders imaginators - crash bandicoot edition - playstation 4,1,0,0,2,2,5,3.8
the spell trial [download],2,1,0,1,1,5,2.6
the elder scrolls iv: oblivion - 5th anniversary edition collector's steelbook- pc,0,1,0,3,1,5,3.8
generator rex - nintendo 3ds,0,0,0,0,5,5,5.0
guild wars 2: heart of thorns [online game code],1,0,2,1,1,5,3.2
otomedius excellent special edition -xbox 360,0,0,0,1,4,5,4.8
rampage 2 universal tour,0,0,1,1,3,5,4.4
kirby tilt n' tumble,0,0,1,1,3,5,4.4
are you smarter than a 5th grader? - nintendo ds,0,0,1,1,3,5,4.4
playstation 4 studded controller skin by foamy lizard ® particlegrip premium protective anti-slip silicone grip case cover for ps4 controller (graviton - black),0,1,0,3,1,5,3.8
sniper elite iii: collector's edition - playstation 4 collector's edition,0,0,0,1,4,5,4.8
clive barker's undying - pc,0,0,0,4,1,5,4.2
gradius,0,0,1,1,3,5,4.4
atari anniversary advance,0,1,0,2,2,5,4.0
college hoops 2k8 - playstation 3,1,0,0,0,4,5,4.2
test drive,1,0,2,1,1,5,3.2
emperor: rise of the middle kingdom - pc,0,0,0,3,2,5,4.4
shadow shelter [download],1,1,0,2,1,5,3.2
retro-bit dreamcast - cable - vga cable (retro-bit),0,0,1,0,4,5,4.6
wolf link amiibo jp model (the legend of zelda series),0,0,0,0,5,5,5.0
mall tycoon - pc,2,2,0,0,1,5,2.2
fight night round 2 - xbox,0,0,2,2,1,5,3.8
age of wonders ii: the wizard's throne,0,0,1,2,2,5,4.2
strike force bowling - playstation 2,0,0,1,0,4,5,4.6
ps3 500 gb god of war ascension legacy bundle,0,1,0,0,4,5,4.4
winback: covert operations - playstation 2,1,0,1,2,1,5,3.4
nights into dreams - sega saturn,0,0,0,1,4,5,4.8
sea legends: phantasmal light (collector's edition) [download],0,0,1,1,3,5,4.4
high heat baseball 2003 - pc,1,0,1,1,2,5,3.6
sega smash pack (ecco the dolphin / golden axe / sonic spinball),0,0,1,0,4,5,4.6
best of tests - nintendo ds,0,0,4,0,1,5,3.4
disney infinity replacement portal base only wii wii u ps3 ps4 - game or figures not included,0,0,0,1,4,5,4.8
missile command,0,0,0,1,4,5,4.8
zettaguard dual slot sony playstation 4 ps4 controller led light charging station stand charger,0,0,2,2,1,5,3.8
medieval: total war - pc,0,0,1,0,4,5,4.6
ps3 charge station,0,0,0,0,5,5,5.0
prince of persia: revelations - sony psp,0,0,2,1,2,5,4.0
rollercoaster tycoon 3: soaked! expansion - pc,0,1,0,2,2,5,4.0
kelux kinect sensor 2 tv mounting clip (xbox one),1,0,1,0,3,5,3.8
nintendo ds lite game card case,0,1,0,2,2,5,4.0
royal envoy: campaign for the crown [download],1,0,0,2,2,5,3.8
dance dance revolution supernova - playstation 2 (game),0,0,1,2,2,5,4.2
baten kaitos origins - gamecube,0,0,0,1,4,5,4.8
blade of darkness - pc,0,0,1,3,1,5,4.0
marvel ultimate alliance greatest hits,0,0,0,2,3,5,4.6
playstation portable limited edition madden nfl 09 entertainment pack- metallic blue,0,0,0,2,3,5,4.6
the typing of the dead: overkill [download],0,0,0,3,2,5,4.4
kill.switch,0,0,2,2,1,5,3.8
killzone shadow fall: season pass - ps4 [digital code],1,0,1,1,2,5,3.6
the elder scrolls v: skyrim steelbook edition - xbox one,0,0,0,0,5,5,5.0
marvel super hero squad: comic combat - playstation 3,0,0,1,1,3,5,4.4
black eva skin carry hard bag pouch case cover for nintendo 3ds xl,0,0,1,2,2,5,4.2
wizardry 8 - pc,1,2,1,1,0,5,2.4
sims 2 pets - gamecube,0,0,2,0,3,5,4.2
ether one - playstation 4,0,1,1,3,0,5,3.4
hde silicone skin for xbox one controller protective grip silicone rubber cover for wireless xbox one / s / x gamepad,1,1,1,2,0,5,2.8
the sims 2 pets - playstation 2,1,0,0,0,4,5,4.2
the wolf among us episode 1: faith - ps3 [digital code],1,0,1,1,2,5,3.6
disney infinity 3.0 edition: star wars the force awakens kylo ren light fx figure,0,0,0,0,5,5,5.0
spongebob squarepants featuring nicktoons: globs of doom - nintendo wii,0,0,3,0,2,5,3.8
sniper: ghost warrior 2 [online game code],0,1,2,0,2,5,3.6
fatal frame 2 - xbox,0,1,0,0,4,5,4.4
prey - pc,3,0,1,0,1,5,2.2
microsoft flight simulator x standard dvd - pc,0,0,0,1,4,5,4.8
chima eris fun pack - lego dimensions,0,0,0,1,4,5,4.8
price is right decades - xbox 360,1,0,2,1,1,5,3.2
nhl 07 - xbox 360,0,0,1,1,3,5,4.4
corvette - playstation 2,0,0,4,0,1,5,3.4
the walking dead season 2 [download],0,1,1,1,2,5,3.8
ps3 component av cable + usb 2.0 cable pack (cable length - 10 ft.),0,0,0,0,5,5,5.0
privacy one - xbox one,1,0,0,0,4,5,4.2
jewel link chronicles: mountains of madness - nintendo ds,1,0,0,1,3,5,4.0
axis 10' charging cable - playstation 4,1,0,0,1,3,5,4.0
"jiulyning crystal case compatible with nintendo new 3ds xl/ll, clear",0,0,0,1,4,5,4.8
wipeout 2 - nintendo wii,0,0,1,0,4,5,4.6
nhl 07 - playstation 2,0,1,2,1,1,5,3.4
singularity [online game code],0,0,0,3,2,5,4.4
supreme commander - xbox 360,0,0,0,2,3,5,4.6
call of duty war chest [download],1,0,1,2,1,5,3.4
just dance disney party 2 - wii standard edition,0,0,0,2,3,5,4.6
barbie in the 12 dancing princesses - playstation 2,0,1,1,0,3,5,4.0
nintendo land with luigi wii remote plus controller - wii u,0,0,0,2,3,5,4.6
the sims 2: apartment pets - nintendo ds,1,1,1,1,1,5,3.0
street fighter anniversary collection,0,0,1,0,4,5,4.6
venetica - playstation 3,0,0,3,1,1,5,3.6
dungeons and dragons classic anthology - pc,0,0,1,0,4,5,4.6
shadow warrior [online game code],0,0,0,1,4,5,4.8
disney infinity series 2 power disc halloweentown sky [16 of 20],0,0,0,0,5,5,5.0
microsoft xbox live 12 month gold card,1,0,0,0,4,5,4.2
dream inn: driftwood [download],0,0,2,1,2,5,4.0
rogue spear mission pack:  urban operations - pc,0,0,0,0,5,5,5.0
adventure time: explore the dungeon because i don't know! 3ds,1,2,1,0,1,5,2.6
ps3 fighting commander 3 pro,0,0,0,3,2,5,4.4
lego the hobbit - playstation vita,0,0,0,0,5,5,5.0
wonderbook: book of potions (ps3),0,0,0,2,3,5,4.6
xbox360 fighting stick vx,0,0,1,1,3,5,4.4
madagascar 2: escape 2 africa - wii,0,0,0,2,3,5,4.6
1701 a. d.: gold edition,0,0,2,2,1,5,3.8
abyss: the wraiths of eden [download],0,0,1,2,2,5,4.2
dancedancerevolution ii - nintendo wii,0,0,1,1,3,5,4.4
triple play baseball,0,2,0,2,1,5,3.4
turtle beach - ear force xbox 360 audio adapter cable - xbox 360 (discontinued by manufacturer),0,0,0,1,4,5,4.8
nickelodeon dance - xbox 360,0,0,0,0,5,5,5.0
gex 3 deep cover gecko,0,0,0,3,2,5,4.4
turtle beach call of duty: mw3 ear force foxtrot limited edition universal amplified stereo gaming headset,0,1,0,2,2,5,4.0
the elder scrolls v: skyrim dlc: dawnguard [online game code],0,0,1,0,4,5,4.6
nintendo isabelle winter outfit amiibo - nintendo wii u,0,0,0,1,4,5,4.8
cars 2 3ds,0,0,0,2,3,5,4.6
lunar knights: vampire hunters - nintendo ds,0,0,0,3,2,5,4.4
mario tennis,0,0,0,2,3,5,4.6
gtr 2: realism redefined - pc,0,0,3,1,1,5,3.6
a bug's life ps,1,1,3,0,0,5,2.4
grand theft auto 2 - pc,0,0,0,2,3,5,4.6
dishonored 2 premium collector's edition - xbox one,0,0,0,0,5,5,5.0
call of duty: roads to victory - sony psp,0,0,0,2,3,5,4.6
age of wonders - pc,0,0,0,4,1,5,4.2
wii hooked! real motion fishing w/controller,1,0,0,4,0,5,3.4
body harvest,0,0,2,0,3,5,4.2
contra: legacy of war,0,0,2,1,2,5,4.0
saint's row double pack limited edition -xbox 360,0,0,2,3,0,5,3.6
incredibles 2 rise of the underminer - gamecube,0,0,0,0,5,5,5.0
lost in blue 3 - nintendo ds,2,0,0,2,0,4,2.5
pro evolution soccer 2008 - nintendo wii,0,0,0,0,4,4,5.0
glover,0,2,1,0,1,4,3.0
tom clancy's the division (gold edition) - pc,0,0,0,1,3,4,4.75
nintendo 2ds red console with yoshi's new island game,0,0,0,2,2,4,4.5
go diego go safari rescue - nintendo wii,0,0,0,4,0,4,4.0
"hde rechargeable li-ion 3.6v battery pack replacement for sony psp-2000, psp-3000",0,0,0,0,4,4,5.0
league of legends $25 gift card – 3500 riot points - na server only [online game code],1,0,0,0,3,4,4.0
mobile suit gundam senki record u.c. 0081 [japan import],0,1,0,1,2,4,4.0
rollercoaster tycoon,1,1,0,1,1,4,3.0
godzilla destroy all monsters - xbox,0,0,0,3,1,4,4.25
dreamgear nintendo wii racing wheel (white),0,0,0,0,4,4,5.0
playstation 2 dvd remote control,0,0,1,0,3,4,4.5
anno 2205 standard edition [online game code],1,0,1,0,2,4,3.5
blade runner - pc,1,0,1,0,2,4,3.5
bowser amiibo - japan import (super smash bros series),0,0,0,0,4,4,5.0
wii les paul wireless guitar,0,0,0,2,2,4,4.5
major league baseball 2k8 - playstation 3,2,0,0,0,2,4,3.0
wipeout,1,0,0,1,2,4,3.75
minecraft for pc/mac [online game code],1,0,1,1,1,4,3.25
buzz: the hollywood quiz bundle - playstation 2,0,2,2,0,0,4,2.5
yueton 5 pairs replacement cat pad style silicone analog controller joystick thumb stick grip cap cover for sony playstation 4 controller,0,0,0,0,4,4,5.0
"xbox one controller opening kit best screwdriver set | not made in china | repair elite & s controllers | replace buttons, shells, thumbsticks, parts & accessories | every gamer must have",0,0,0,1,3,4,4.75
the incredible hulk - pc,0,0,3,0,1,4,3.5
mysims racing - nintendo wii,0,0,1,2,1,4,4.0
tomee s-video av cable for ps3/ ps2/ ps1,0,0,0,1,3,4,4.75
tetris plus,0,0,0,1,3,4,4.75
league of legends $10 gift card – 1380 riot points - na server only [online game code],0,0,0,0,4,4,5.0
playstation vita wi-fi model glacier white (pch-2000za22) japanese ver. japan import,1,0,0,0,3,4,4.0
afterglow lvl 5+ for ps4,0,1,0,2,1,4,3.75
empire earth 2 - pc,0,0,1,3,0,4,3.75
dynasty warriors 8 empires - xbox one,0,0,0,1,3,4,4.75
the spiderwick chronicles - xbox 360,0,0,0,2,2,4,4.5
r.u.s.e. - xbox 360,0,0,2,0,2,4,4.0
karaoke revolution presents: american idol encore bundle - xbox 360,0,0,0,2,2,4,4.5
guitar hero van halen - nintendo wii,1,2,1,0,0,4,2.0
smaacc cooling fan with dual charging station for ps4 controllers/dualshock 4 controllers,0,0,0,0,4,4,5.0
mcbazel audio video av cable for sega mega drive genesis 2,0,0,0,1,3,4,4.75
sega superstars eyetoy - playstation 2,0,0,1,0,3,4,4.5
need for speed: prostreet - pc,1,1,0,0,2,4,3.25
ark: survival evolved early access [online game code],1,0,0,1,2,4,3.75
age of empires: mythologies - nintendo ds,0,0,0,1,3,4,4.75
culpa innata - pc,0,1,1,0,2,4,3.75
tomee stylus pen set for new 3ds xl (3-pack),0,0,0,0,4,4,5.0
guinness world records: the videogame - nintendo wii,0,1,0,1,2,4,4.0
heroes of might & magic v: tribes of the east - pc,0,0,1,0,3,4,4.5
call of duty: black ops iii - season pass - playstation 4 [download code],0,0,1,1,2,4,4.25
wii 5-in-1 fitness bundle,0,1,0,0,3,4,4.25
playstation 2 guitar hero wireless kramer striker controller,0,0,0,0,4,4,5.0
law and order 2: double or nothing - pc,0,0,1,2,1,4,4.0
legend of kay anniversary - playstation 4,1,0,2,1,0,4,2.75
disney's goof troop,1,0,0,1,2,4,3.75
rugrats search for reptar,0,0,0,2,2,4,4.5
guitar hero iii: legends of rock bundle with guitar - pc/mac (wired bundle),2,0,0,2,0,4,2.5
san francisco rush extreme racing - nintendo 64,1,0,1,1,1,4,3.25
nhl 2004 (ps2) - pre-owned,0,1,1,1,1,4,3.5
simcity creator - nintendo wii,0,0,1,0,3,4,4.5
xbox 360 guitar hero world tour band bundle,0,1,0,0,3,4,4.25
"rechargeable li-ion 3.6v battery pack for sony psp-2000, psp-3000",0,0,1,0,3,4,4.5
pink sleeve silicone skin case for nintendo wii fit,0,0,0,1,3,4,4.75
day of defeat - pc,0,0,2,0,2,4,4.0
the jackbox party pack - playstation 4,0,0,1,0,3,4,4.5
dance dance revolution x with dance mat - playstation 2,1,0,1,0,2,4,3.5
legend of spyro: dawn of the dragon - xbox 360,0,0,0,2,2,4,4.5
flipwords 2 (jewel case),0,0,0,1,3,4,4.75
super nintendo turbo controller (asciipad),0,0,0,0,4,4,5.0
dance dance revolution hottest party 2 with dance mat - nintendo wii,0,0,1,2,1,4,4.0
scene it? box office smash (gameonly) - xbox 360,0,0,0,2,2,4,4.5
singstar 80's (stand alone) - playstation 2,0,0,0,0,4,4,5.0
imagine teacher - nintendo ds,0,0,1,0,3,4,4.5
intec g7733 quad charge station for ps3,0,0,1,1,2,4,4.25
code of honor 2: conspiracy island - pc,0,1,1,0,2,4,3.75
gears of war 2 amazon.com exclusive lancer - xbox 360,0,2,1,1,0,4,2.75
dance dance revolution supernova 2 - playstation 2 (game),0,0,1,1,2,4,4.25
ts-h943 dvd-rom drive for xbox 360,1,1,0,2,0,4,2.75
nba '09 the inside - playstation 3,0,0,1,2,1,4,4.0
lego dimensions starter pack - xbox 360,1,0,0,0,3,4,4.0
"rhapsody, a musical adventure - nintendo ds",0,1,2,0,1,4,3.25
singstar vol. 2 - playstation 3 (stand alone),0,0,2,0,2,4,4.0
singstar country stand alone - playstation 2,0,0,0,0,4,4,5.0
singstar legends stand alone - playstation 2 (stand alone),0,0,0,0,4,4,5.0
ortz ps4 wireless mini bluetooth keyboard - best keypad adapter for dualshock controller for playstation 4 [black],1,0,1,1,1,4,3.25
warriors orochi 2 - xbox 360,0,0,0,2,2,4,4.5
disney's bolt - xbox 360,0,0,2,1,1,4,3.75
virtua fighter 2,0,0,0,1,3,4,4.75
steins gate (uk import),0,0,0,0,4,4,5.0
journey - ps3/ps4 [digital code],0,0,0,0,4,4,5.0
shepherd's crossing,0,0,1,2,1,4,4.0
7 wonders 3 (treasures of seven),2,0,0,0,2,4,3.0
logitech playstation 3 driving force wireless force feedback wheel,0,0,0,3,1,4,4.25
nancy drew ultimate dare bundle (4 games in 1),0,0,0,0,4,4,5.0
skylanders superchargers: vehicle shark tank character pack,0,0,0,0,4,4,5.0
skylanders superchargers: drivers big bubble pop fizz character pack,0,0,0,0,4,4,5.0
viva piata party animals - xbox 360,2,0,1,1,0,4,2.25
army men sarge's heroes,0,0,1,0,3,4,4.5
mysims - pc,1,0,0,0,3,4,4.0
agatha christie: death on the nile - pc,0,0,2,1,1,4,3.75
college hoops 2k8 - xbox 360,0,0,1,0,3,4,4.5
pac-man,0,0,0,0,4,4,5.0
ps3 guitar hero les paul wireless guitar,0,1,1,0,2,4,3.75
nanostray 2 - nintendo ds,0,0,0,2,2,4,4.5
tiger woods pga tour 10 - playstation 3,0,0,1,2,1,4,4.0
hde silicone skin for xbox one controller protective grip silicone rubber cover for wireless xbox one / s / x gamepad,0,1,1,2,0,4,3.25
socom u.s. navy seals (no headset) - playstation 2,1,0,0,0,3,4,4.0
designer skin for playstation 3 remote controller - weeds black,0,0,0,1,3,4,4.75
kung fu panda - playstation 2,0,0,0,0,4,4,5.0
rock band bass pedal - pedal metal with hinge,0,0,0,0,4,4,5.0
ds lite mini folio - pink,0,0,0,1,3,4,4.75
nintendo ds lite charge stand,0,0,2,0,2,4,4.0
nintendo ds lite protector - super mario version,0,0,0,0,4,4,5.0
space rangers 2: reboot - pc,1,0,0,1,2,4,3.75
the command and conquer collection - pc,0,0,0,0,4,4,5.0
mario kart 8 dlc pack 1 + pack 2 bundle - wii u [digital code],0,0,0,0,4,4,5.0
jigglypuff amiibo (super smash bros series),0,0,0,1,3,4,4.75
rayman raving rabbids 2 - nintendo ds,0,0,0,1,3,4,4.75
petz hamsterz 2 - nintendo ds,0,0,1,1,2,4,4.25
ortz ps4 vertical stand with cooling fan [charges 4 controllers],0,0,1,1,2,4,4.25
goosebumps the game 3ds - nintendo 3ds,0,1,0,0,3,4,4.25
imagine: fashion designer,0,0,1,3,0,4,3.75
imagine: babyz - nintendo ds,2,0,0,1,1,4,2.75
singstar queen - stand alone - playstation 3,0,0,0,2,2,4,4.5
pac-man vs. / pac-man world 2,0,0,0,1,3,4,4.75
mayflash f500 arcade fight stick for ps4/ps3/xbox one/xbox 360/pc/android/switch/neogeo mini,1,0,0,0,3,4,4.0
total war: attila special edition,0,0,1,2,1,4,4.0
avencast: rise of the mage - pc,0,0,0,3,1,4,4.25
tom clancy's rainbow six,0,0,1,2,1,4,4.0
tokyo xtreme racer 3 - playstation 2,0,0,1,2,1,4,4.0
jake hunter: detective chronicles - nintendo ds,1,0,1,1,1,4,3.25
vigilante 8: 2nd offense,1,1,1,0,1,4,2.75
call of duty 4: modern warfare - mac,0,0,0,0,4,4,5.0
super mario maker - wii u [digital code],0,0,0,1,3,4,4.75
8mb memory card for ps2,0,0,0,0,4,4,5.0
naruto: ultimate ninja heroes 2: the phantom fortress - sony psp,0,0,0,2,2,4,4.5
space chimps - xbox 360,0,0,0,2,2,4,4.5
psp component av cable,2,0,0,0,2,4,3.0
hde dual wii remote charging station with battery packs,1,0,1,1,1,4,3.25
buffy the vampire slayer: chaos bleeds - xbox,0,0,1,1,2,4,4.25
fifa 16 - standard edition - xbox 360,0,0,0,0,4,4,5.0
yu-gi-oh! world championship tournament 2008 - nintendo ds,0,0,0,2,2,4,4.5
xbox 360 rock band drum set,0,0,1,1,2,4,4.25
everquest 2 (dvd-rom) - pc,2,0,1,1,0,4,2.25
elder scrolls online: tamriel unlimited - multiple (windows and mac),0,0,0,1,3,4,4.75
yu-gi-oh! falsebound kingdom - gamecube,0,2,1,0,1,4,3.0
shellshock: nam '67,0,0,1,2,1,4,4.0
pure - pc,0,0,0,2,2,4,4.5
zoids: battle legends,0,0,1,0,3,4,4.5
major league baseball 2k9 - nintendo wii,2,1,1,0,0,4,1.75
egyptian prophecy - pc,0,0,1,1,2,4,4.25
star wars: force commander - pc,1,0,1,1,1,4,3.25
insten® usb intercooler 4 cooling fan + hdmi cable compatible with sony ps3,1,3,0,0,0,4,1.75
mlb 2k9 xbox360,0,0,1,0,3,4,4.5
ness amiibo (super smash bros series),1,0,0,1,2,4,3.75
thq tak & the power of juju,0,0,0,0,4,4,5.0
official guitar hero world tour microphone for ps3 / wii / xbox 360,0,0,0,1,3,4,4.75
ps3 remote control,0,0,1,2,1,4,4.0
usb enabled lan adapter compatible with nintendo wii,0,0,0,0,4,4,5.0
mighty no. 9 signature edition - playstation 4,0,0,0,1,3,4,4.75
universal foam yoga mat for wii fit,0,0,2,2,0,4,3.5
xbox 360 arcade console,0,1,1,0,2,4,3.75
need for speed - deluxe edition - xbox one,1,0,1,1,1,4,3.25
wii fit travel bag,0,0,2,2,0,4,3.5
tiger woods pga tour 09 - playstation 2,0,0,0,2,2,4,4.5
sacred - pc,1,1,1,0,1,4,2.75
microsoft xbox one 500gb console system with kinect (certified refurbished),1,0,0,1,2,4,3.75
price is right decades - nintendo wii,0,0,0,2,2,4,4.5
call of duty: black ops iii - gold edition - playstation 4,0,0,0,0,4,4,5.0
dotop nunchuck controller for nintendo wii video game black,0,0,1,1,2,4,4.25
"pdp rock candy wireless controller, green - playstation 3",0,0,0,2,2,4,4.5
digimon world ds,0,1,0,2,1,4,3.75
loving life with hello kitty & friends - nintendo ds,0,0,1,0,3,4,4.5
"mudder protective travel carrying case cover for nintendo 2ds, blue",0,0,0,0,4,4,5.0
disney's hannah montana - nintendo ds,0,0,3,0,1,4,3.5
who wants to be a millionaire - xbox 360,0,1,1,1,1,4,3.5
call of duty ghosts - ps3 [digital code],0,0,2,0,2,4,4.0
loading human - playstation vr,0,1,1,1,1,4,3.5
nintendo selects: the legend of zelda: ocarina of time - 3ds [digital code],1,0,0,0,3,4,4.0
nascar: unleashed,0,1,0,1,2,4,4.0
hde media remote control for microsoft xbox one / s / x wireless multimedia entertainment console controller,0,0,0,0,4,4,5.0
assassin's creed iv black flag gold edition [online game code],1,0,0,0,3,4,4.0
tomee 2 player link cable for gbc/ gbp/ gb,1,0,1,0,2,4,3.5
hde black silicone skin for xbox 360 controller,0,0,1,1,2,4,4.25
star wars empire at war: forces of corruption - pc,1,0,1,2,0,4,3.0
paragon - essentials edition - playstation 4,1,0,0,0,3,4,4.0
call of duty: ghosts - ps4 [digital code],0,0,0,2,2,4,4.5
trine 2: complete story - ps4 [digital code],0,0,0,2,2,4,4.5
penguins of madagascar: dr. blowhole returns again! - playstation 3,0,0,0,1,3,4,4.75
"for ps4 controller silicone case cover, insten 4-pack silicone controller case combo compatible with playstation 4 ps4 controller, black/ red/ blue/ clear white",1,0,1,1,1,4,3.25
"everydaysource compatible with playstation 4 (ps4) 4 packs silicone controller case combo: black, clear white, red, blue",0,1,1,2,0,4,3.25
headset earbud microphone earpiece for ps4 controller headphones,0,0,0,0,4,4,5.0
call of duty: black ops iii - gold edition - xbox one,1,1,0,0,2,4,3.25
gold chrome xbox 360 controller shell kit,1,2,0,1,0,4,2.25
7th guest - pc,0,2,0,1,1,4,3.25
seojack wifi ac600mbps usb wireless adapter with powerful antenna for windows xp/10/7/8/8.1/10(32/64bits),0,0,2,1,1,4,3.75
"shogun 2: fall of the samurai, limited edition - pc",1,0,0,1,2,4,3.75
blazblue: continuum shift extend - standard edition - xbox 360,0,1,0,0,3,4,4.25
gloomy pug nintendo 3ds cover skin decal sticker vinyl matte finish + free screen protectors (for old version prior 2015),0,0,0,2,2,4,4.5
nintendo 3ds with super mario 3d land - flame red,0,0,0,0,4,4,5.0
nintendo 3ds - limited edition with the legend of zelda ocarina of time 3d,0,0,0,1,3,4,4.75
nintendo wii console w/skylanders giants starter pack,1,1,1,0,1,4,2.75
max payne 3: special edition - playstation 3,0,0,1,0,3,4,4.5
xbox 360 4gb kinect holiday value bundle features two great games: kinect sports: season two and kinect adventures,1,0,0,1,2,4,3.75
spongebob squarepants creature from the krusty krab - playstation 2,0,1,0,2,1,4,3.75
nicktoons battle for volcano island - playstation 2,0,0,1,1,2,4,4.25
retro-bit sega saturn s-video a/v cable,0,0,0,1,3,4,4.75
god of war origins collection & dualshock3 wireless controller - playstation 3 (ultimate combo pack),0,0,1,0,3,4,4.5
haunted manor: lord of mirrors,0,0,1,2,1,4,4.0
madden nfl 2002,0,0,2,0,2,4,4.0
amazon exclusive: gears of war 4 collector's edition - outsider variant (includes ultimate edition steelbook + season pass) - xbox one,0,0,0,0,4,4,5.0
nyko power kit - rechargeable battery and replacement cover with micro-usb charging cable for xbox one,1,0,0,1,2,4,3.75
nhl hitz 20-02,0,0,1,1,2,4,4.25
kmd wii/gamecube komodo memory card 16mb 251 blocks,0,0,0,2,2,4,4.5
mafia iii collectors edition - playstation 4,1,0,1,0,2,4,3.5
simcity cities of tomorrow [online game code],1,0,2,1,0,4,2.75
redemption cemetery: curse of the raven,0,0,1,0,3,4,4.5
fantastic four - gamecube,0,0,0,1,3,4,4.75
nba 2k17 - legend edition - xbox one,0,0,0,0,4,4,5.0
anno: 1404 - gold edition,0,0,1,1,2,4,4.25
saint's row 2 - playstation 3 (platinum),1,0,1,0,2,4,3.5
fallout: new vegas ultimate edition [online game code],2,0,0,0,2,4,3.0
rayman origins - with artbook - xbox 360 (standard with amazon exclusive art book),0,0,0,1,3,4,4.75
naruto shippuden ultimate ninja storm generations - playstation 3,0,2,0,1,1,4,3.25
hde (tm) black carrying case for nintendo dsi/ds lite/3ds console,0,0,0,1,3,4,4.75
"star wars: the best of pc (empire at war, knights of the old republic, star wars battlefront, republic commando)",0,0,0,2,2,4,4.5
xbox 360 wireless headset communicator,0,1,1,0,2,4,3.75
kontrolfreek fps freek phantom for xbox one controller,0,0,0,1,3,4,4.75
diner dash 2 - pc,0,0,1,1,2,4,4.25
the hidden: an augmented reality ghost hunting adventure,1,0,0,3,0,4,3.25
lego harry potter: years 5-7 - sony psp,0,0,0,1,3,4,4.75
no one lives forever,1,1,1,0,1,4,2.75
tecmo bowl - nintendo nes,0,0,0,1,3,4,4.75
kmd e av cable - xbox 360,0,0,0,0,4,4,5.0
armored core 4 - playstation 3,0,1,2,0,1,4,3.25
star wars: rogue squadron 3d (jewel case),1,0,0,1,2,4,3.75
tomee nes to usb controller adapter,0,0,0,0,4,4,5.0
spider-man: the movie - pc,1,1,1,0,1,4,2.75
cabelas: big game hunter pro hunts - xbox 360,0,0,0,1,3,4,4.75
playstation 4 studded controller skin by foamy lizard ® particlegrip premium protective anti-slip silicone grip case cover for ps4 controller (electron - blue),0,0,0,2,2,4,4.5
microsoft xbox 360 chrome series wireless controller (purple),0,0,0,0,4,4,5.0
world of warcraft: burning crusade collector's edition,0,0,0,0,4,4,5.0
kinect sesame street tv - xbox 360,0,0,0,1,3,4,4.75
heroes of might and magic v hammers of fate expansion pack - pc,0,0,2,1,1,4,3.75
big fish: hidden expedition 6: the smithsonian's hope diamond - pc,0,0,1,1,2,4,4.25
splashdown,0,0,0,3,1,4,4.25
chessmaster 9000 - pc,1,0,2,0,1,4,3.0
lock on: modern air combat - pc,0,0,2,1,1,4,3.75
tales from the borderlands - xbox one,1,0,0,1,2,4,3.75
hisurprise 2x black battery cover for microsoft xbox 360,0,0,0,2,2,4,4.5
the elder scrolls iv: oblivion game of the year deluxe [online game code],0,0,0,0,4,4,5.0
universal studios theme park,1,0,0,0,3,4,4.0
the elder scrolls v: skyrim [online game code],0,0,1,0,3,4,4.5
sharkoon x-tatic sr gaming headset with dolby headphone technology for ps3/pc/xbox 360,0,0,1,2,1,4,4.0
naruto shippuden: ultimate ninja storm generations - xbox 360 (limited),0,0,0,1,3,4,4.75
pro evolution soccer 2012 - nintendo wii,0,0,0,2,2,4,4.5
tom and jerry tales,0,0,0,1,3,4,4.75
new snes tomee usb controller eight-way directional pad & six digital buttons works for pc & mac,0,1,0,1,2,4,4.0
"gaems vanguard personal gaming environment for xbox one s, xbox one, ps4, ps3, xbox 360 (consoles not included) - xbox one",0,0,0,0,4,4,5.0
country dance kinect - xbox 360,0,0,0,0,4,4,5.0
saints row iv - thank you pack [online game code],1,0,0,0,3,4,4.0
dark souls iii [online game code],1,0,0,0,3,4,4.0
mad catz gears of war 3 throat communicator for xbox 360,2,0,0,0,2,4,3.0
air flo controller for xbox 360 - wired,0,1,1,2,0,4,3.25
uno/skip-bo/uno freefall - nintendo ds,0,0,0,0,4,4,5.0
playstation vita memory card 64gb (pch-z641g),1,0,0,0,3,4,4.0
clue/mouse trap/perfection/aggravation - nintendo ds,0,0,1,0,3,4,4.5
flow - ps vita / ps4 / ps3 [digital code],0,2,1,0,1,4,3.0
disney infinity agent p,0,0,0,0,4,4,5.0
playstation 4 black airform pouch pouch case bag for ps4 controller gamepad+ wrist strap soleil,0,0,0,1,3,4,4.75
just dance summer party - nintendo wii,0,0,0,1,3,4,4.75
travel pack - 3 in 1 - hidden object game [download],0,0,1,1,2,4,4.25
jillian michaels fitness adventure - xbox 360,1,0,2,0,1,4,3.0
monster madness:  battle for suburbia - xbox 360,0,0,2,1,1,4,3.75
microsoft copper shadow wireless controller - xbox one,0,0,0,0,4,4,5.0
tosa blue light stand - playstation 4,0,0,0,0,4,4,5.0
touhou genso rondo: bullet ballet - playstation 4 standard edition,0,0,2,1,1,4,3.75
lego star wars ii: the original trilogy (pc games),0,1,0,0,3,4,4.25
nba live 2002,0,0,2,1,1,4,3.75
season of mystery: the cherry blossom murders [online game code],2,0,0,1,1,4,2.75
joytech 16mb gamecube memory card,0,0,0,0,4,4,5.0
bejeweled 3 [instant access],1,0,1,0,2,4,3.5
sonic adventure 2 [download],0,0,0,0,4,4,5.0
squidgrip for ps3 controller (controller not included),0,0,1,1,2,4,4.25
hitman trilogy hd - playstation 3,0,0,0,1,3,4,4.75
insten av composite cable compatible with nintendo wii,0,0,0,0,4,4,5.0
space quest collection - pc,0,0,2,1,1,4,3.75
assassin's creed iii [online game code],1,0,0,1,2,4,3.75
everydaysource compatible with nintendo 3ds xl 12-piece mini stylus,0,0,0,3,1,4,4.25
burnout paradise bonus vehicle pack [online game code],0,0,1,0,3,4,4.5
playstation vita 3g bundle - 4gb with playstation plus and unit 13 voucher,0,0,0,0,4,4,5.0
"skullcandy slyr gaming headset, black/yellow (smslfy-207)",0,0,0,0,4,4,5.0
the elder scrolls v: skyrim steelbook edition - playstation 4,0,0,0,0,4,4,5.0
ace combat 2,0,1,0,0,3,4,4.25
marvel nemesis rise of the imperfects - xbox,1,2,0,0,1,4,2.5
pro controller u for wii and wii u - gold le,0,0,1,1,2,4,4.25
hde hard drive migration data transfer cable for xbox 360,0,1,0,1,2,4,4.0
simcity amusement park pack [online game code],1,0,1,1,1,4,3.25
sid meier's civilization v: brave new world [online game code],1,0,0,0,3,4,4.0
playstation2 action gamer pack,0,0,1,3,0,4,3.75
ps2 memory card (8 mb),0,1,1,0,2,4,3.75
wormlight: silver - gameboy color,2,0,1,0,1,4,2.5
the sacred rings - pc,0,0,1,2,1,4,4.0
hitman absolution: professional edition [download],1,0,1,0,2,4,3.5
kontrol freek thumb stick addon phantom 360 white (xbox 360),0,0,0,0,4,4,5.0
not for sale-xbox one replacement console - standard edition,0,0,0,0,4,4,5.0
nhl 2002 xbox,0,0,1,1,2,4,4.25
gladius - xbox,0,0,0,3,1,4,4.25
farming simulator 17 - xbox one,0,0,1,0,3,4,4.5
invizimals umd with psp camera,0,0,0,3,1,4,4.25
neopets: the darkest faerie - playstation 2,0,0,0,1,3,4,4.75
the guided fate paradox - playstation 3,0,1,0,3,0,4,3.5
high heat baseball 2004 ps2,0,0,0,1,3,4,4.75
auto modellista,0,1,1,1,1,4,3.5
tiger woods pga tour 2006 - playstation 2,0,1,1,0,2,4,3.75
prince of persia: the two thrones - pc,0,0,0,2,2,4,4.5
spartan: total warrior - xbox,0,0,0,0,4,4,5.0
disney's planes - nintendo wii,0,0,0,1,3,4,4.75
nyko charge block solo - controller charging station with patented charge dongle and micro-usb/ac power cord for playstation 4,0,0,1,1,2,4,4.25
south park: the fractured but whole steelbook gold edition (includes season pass subscription) - playstation 4,0,0,0,0,4,4,5.0
the sims 2 - sony psp,1,1,1,0,1,4,2.75
dance dance revolution mario mix - gamecube,0,0,0,3,1,4,4.25
the sims 3: university life [online game code],1,0,0,2,1,4,3.5
golden trails 3: the guardian's creed [download],0,0,0,2,2,4,4.5
final fantasy xi: seekers of adoulin [download],0,2,0,0,2,4,3.5
quake iii: revolution,0,1,1,1,1,4,3.5
scribblenauts collection - nintendo ds,0,0,0,0,4,4,5.0
disney infinity starter pack 3ds,1,0,1,1,1,4,3.25
hakuoki: memories of the shinsengumi - nintendo 3ds,1,0,0,2,1,4,3.5
sonic & all-stars racing transformed [online game code],0,0,0,0,4,4,5.0
halo wars 2 - ultimate edition - xbox one,0,0,0,0,4,4,5.0
deadlight [download],1,0,1,2,0,4,3.0
vampire: the masquerade: bloodlines [online game code],0,0,0,1,3,4,4.75
ggg0032 2 pack extension cable for wii classic controller or nintendo gamecube (ngc) 6ft 1.8m,0,0,0,0,4,4,5.0
ps3 320 gb playstation plus instant game collection bundle,0,0,0,0,4,4,5.0
"insten replacement stylus compatible with nintendo ds lite plastic stylus pen, 12-pack",0,0,0,2,2,4,4.5
the lego movie videogame - playstation vita,0,0,0,1,3,4,4.75
neon mains charger for nintendo dsi xl / dsi / 3ds (us 2-pin plug),0,0,1,0,3,4,4.5
sega dreamcast official jump pak pack rumble,0,0,0,1,3,4,4.75
hori nintendo 3ds xl retro mario duraflexi protector,0,0,0,2,2,4,4.5
"ggg0041 dust cover multipack for sega genesis cartridges, storage sleeve for retro video games, protector case",0,0,0,0,4,4,5.0
game of thrones (art book bundle),0,0,2,1,1,4,3.75
nyko speaker stand for vita - playstation vita,0,1,0,2,1,4,3.75
call of duty: ghosts prestige edition - xbox one,0,0,0,1,3,4,4.75
call of cthulhu dark corners of the earth,0,0,3,1,0,4,3.25
mlb 2k12/nba 2k12 combo pack - xbox 360,0,0,1,1,2,4,4.25
pdp afterglow prismatic wireless headset - xbox 360,1,0,0,2,1,4,3.5
3-in-1 super mario bros. / duck hunt / world class track meet,0,0,0,0,4,4,5.0
hori pikachu premium gold protector for new nintendo 3ds xl officially licensed by nintendo & pokemon,0,0,1,0,3,4,4.5
mad catz street fighter x tekken - arcade fightstick pro - line for xbox 360,0,0,1,0,3,4,4.5
flat out 2 - pc (deluxe),0,1,0,2,1,4,3.75
battleship - nintendo wii,0,0,1,0,3,4,4.5
just dance kids 2014 - nintendo wii,0,0,0,2,2,4,4.5
grand theft auto - san andreas [download],0,1,1,1,1,4,3.5
borderlands 2: game of the year edition,0,0,0,0,4,4,5.0
escape from monkey island - pc,0,1,1,1,1,4,3.5
dreamgear playstation 4 dual charge dock,1,0,0,2,1,4,3.5
turtle beach - ear force dp11 gaming headset - dolby surround sound - ps3,0,0,0,2,2,4,4.5
nhl hitz 2002,0,1,0,2,1,4,3.75
wii/gamecube converter ps/ps2 to wii/gamecube w/ dance pad support,0,0,0,0,4,4,5.0
cars - sony psp,0,0,0,1,3,4,4.75
wipeout: create & crash - nintendo wii,0,0,0,2,2,4,4.5
blazblue: central fiction - playstation 4,1,0,0,1,2,4,3.75
cosmos ® black crystal protection hard case cover for playstation ps vita & cosmos brand lcd touch screen cleaning cloth,0,0,0,0,4,4,5.0
power a fus1on tournament controller for xbox 360,0,1,0,2,1,4,3.75
age of empires collector's edition - pc,0,0,1,1,2,4,4.25
for honor: gold edition (includes extra content + season pass subscription) - playstation 4,1,0,1,0,2,4,3.5
game party champions - nintendo wii u,0,1,0,0,3,4,4.25
"nintendo dsi 3.25"" lcd display game system - matte blue",0,0,0,0,4,4,5.0
living legends: ice rose [download],0,0,1,1,2,4,4.25
tomee data/sync cable for ps vita,1,0,1,1,1,4,3.25
the trash pack - nintendo ds,0,0,0,2,2,4,4.5
world soccer winning eleven 9 international - playstation 2,0,0,0,1,3,4,4.75
dance factory - playstation 2,1,1,2,0,0,4,2.25
wipeout 3 - nintendo wii,0,1,0,0,3,4,4.25
ape escape 3 - playstation 2,2,0,0,0,2,4,3.0
fight night round 3 - sony psp,0,0,1,1,2,4,4.25
dungeon lords collector's edition - pc,2,0,1,1,0,4,2.25
levelup rt controller universal storage tower with headset holder,0,0,0,0,4,4,5.0
hotel transylvania - nintendo 3ds,0,0,0,3,1,4,4.25
cosmos ® carbon design protective decal skin sticker for sony playstation ps vita handheld+ cosmos cable tie,0,0,1,1,2,4,4.25
retro link sega genesis classic usb controller for pc and mac,0,2,0,0,2,4,3.5
skylanders imaginators - playstation 4,1,0,0,0,3,4,4.0
angry birds star wars - nintendo wii u,0,0,0,0,4,4,5.0
spongebob squarepants: plankton's robotic revenge - nintendo wii,2,0,0,0,2,4,3.0
magus - playstation 3,0,1,3,0,0,4,2.75
importer520 nintendo wii / nintendo wii u component hdtv av high definition av cable (bulk packaging),0,0,0,0,4,4,5.0
dancedancerevolution ii bundle - nintendo wii,0,0,0,0,4,4,5.0
nba 2k12 (covers may vary),0,0,0,2,2,4,4.5
armored core iii,0,0,1,0,3,4,4.5
ps2 wireless controller,3,0,1,0,0,4,1.5
phineas and ferb ride again - nintendo ds,0,0,0,1,3,4,4.75
"consoletuner titan one for ps4, xbox one, ps3 and xbox 360",1,1,1,0,1,4,2.75
mystery case files: dire grove [download],1,0,0,0,3,4,4.0
madden nfl 08 dvd - pc,1,0,2,1,0,4,2.75
royal envoy 3 [download],0,0,0,3,1,4,4.25
black nintendo 3ds xl with (pre-installed) super mario 3d land game,0,0,0,0,4,4,5.0
crash bandicoot - ps3 [digital code],0,0,0,0,4,4,5.0
tiger woods pga tour 08 dvd - pc,0,0,1,1,2,4,4.25
corpse party: heavenly bundle (2 for 1 sale) - ps vita [digital code],0,0,0,2,2,4,4.5
wipeout: the game,1,1,0,1,1,4,3.0
mystery pi hidden object collection,0,0,0,0,4,4,5.0
new leap motion controller pc & mac real 3d interaction with packaging lm-010,1,0,1,0,2,4,3.5
disney's toy story,0,0,0,2,2,4,4.5
call of duty: advanced warfare atlas limited edition - xbox one,0,0,0,1,3,4,4.75
phantasy star nova,1,0,0,0,3,4,4.0
"murder, she wrote [download]",0,1,0,2,1,4,3.75
escape the museum - nintendo ds,1,2,0,0,1,4,2.5
f1 2014 (formula 1) - xbox 360,0,0,0,1,3,4,4.75
playstation 2 action replay max evo edition,1,1,0,0,2,4,3.25
nascar dirt to daytona,0,1,1,0,2,4,3.75
disney infinity: toy box starter pack (2.0 edition) - xbox one,1,0,0,0,3,4,4.0
call of duty: advanced warfare digital pro edition - ps4 [digital code],1,0,1,0,2,4,3.5
teenage mutant ninja turtles: danger of the ooze - xbox 360,0,0,0,1,3,4,4.75
"playstation ps vita psvita slim 2000 case cover hybrid brushed aluminum metal overlay hard plastic + free screen protector (2nd generation, pch-2xxx version only) (purple)",0,0,1,1,2,4,4.25
fallout: new vegas - pc,0,0,0,2,2,4,4.5
xbox one 500gb console with kinect (no chat headset included),1,0,0,0,3,4,4.0
family feud decades - nintendo wii,0,0,1,1,2,4,4.25
the sims pet stories dvd - pc,0,0,0,2,2,4,4.5
csi: unsolved - nintendo ds,0,0,0,1,3,4,4.75
gauntlet legends,0,0,0,1,3,4,4.75
hyperkin retron 1 gaming console for nes (black),0,0,0,1,3,4,4.75
outdoor action double pack wii remington bird hunt shimano xtreme fishing,0,0,0,1,3,4,4.75
petz nursery 2 - nintendo ds,0,0,1,1,2,4,4.25
majesty - pc,0,0,1,2,1,4,4.0
legendary [download],1,0,1,0,2,4,3.5
chicken shoot,0,1,2,1,0,4,3.0
xbox 360 universal media remote control,1,0,2,0,1,4,3.0
the bigs - nintendo wii,0,0,2,1,1,4,3.75
unreal tournament iii collector's edition - pc,0,0,1,0,3,4,4.5
rock band 3 wireless fender mustang pro-guitar controller for wii,0,0,1,0,3,4,4.5
tiger woods pga tour 12: the masters - nintendo wii,0,0,0,1,3,4,4.75
wii stand (rvl-017),1,0,0,0,3,4,4.0
namco museum 64,0,0,0,2,2,4,4.5
two worlds epic edition [download],0,1,0,2,1,4,3.75
city of heroes collector's dvd edition - pc,0,0,0,3,1,4,4.25
dj hero 2 turntable bundle,0,0,2,1,1,4,3.75
zelda gold - nintendo ds lite complete full housing shell case replacement repair w/ hinge set,0,0,1,1,2,4,4.25
rallisport challenge - pc,0,0,0,0,4,4,5.0
necrovision - free demo [download],2,0,0,0,2,4,3.0
babysitting mama - nintendo wii,0,0,0,3,1,4,4.25
legends of wrestling 2,0,0,2,1,1,4,3.75
hori racing wheel 4 for playstation 3 and 4,2,0,1,1,0,4,2.25
2010 fifa world cup south africa,0,0,1,0,3,4,4.5
fatal frame: maiden of black water - wii u [digital code],0,0,1,1,2,4,4.25
iron man 2 - sony psp,0,1,1,0,2,4,3.75
destiny: the taken king (legendary edition) - playstation 4 [digital code],1,0,0,0,3,4,4.0
disney infinity 3.0 edition: star wars rebels bundle - amazon exclusive,0,0,0,0,4,4,5.0
crash bandicoot action pack - playstation 2,0,0,1,0,3,4,4.5
disney infinity (2.0 edition) [download],1,1,1,0,1,4,2.75
chessmaster the art of learning - sony psp (5th anniversary),0,0,0,1,3,4,4.75
rollercoaster tycoon 2: wacky worlds expansion pack - pc,0,0,0,4,0,4,4.0
king's quest: collection series (king's quest i-vii / the colonel's bequest / the dagger of amon ra / mixed-up mother goose),0,0,1,2,1,4,4.0
ps3 band hero featuring taylor swift - super bundle,1,0,1,0,2,4,3.5
lords of magic: special edition (jewel case),0,0,0,1,3,4,4.75
barn yarn [download],0,0,0,1,3,4,4.75
xbox 360 tony hawk: ride skateboard bundle,1,0,1,0,2,4,3.5
assassin's creed rogue - pc,0,0,0,2,2,4,4.5
sony move charging station with dualshock 4 adapters,1,0,1,0,2,4,3.5
dreamgear rainbow stylus pack 5 precision styluses perfect for new 3ds xl - nintendo 3ds,0,0,0,1,3,4,4.75
skylanders trap team: legendary deja vu character pack,0,0,0,0,4,4,5.0
final fantasy xiv: heavensward - windows,1,0,0,0,3,4,4.0
skylanders superchargers: drivers frightful fiesta character pack,0,0,0,0,4,4,5.0
"nancy drew dossier: lights, camera, curses! - pc",0,0,0,2,2,4,4.5
turtle beach ear force xo seven premium xbox one gaming headset (certified refurbished),1,0,0,0,3,4,4.0
medal of honor: heroes 2 - sony psp,0,0,2,1,1,4,3.75
nhl 10 - playstation 3,0,1,0,0,3,4,4.25
bw® 5 pair/10 pcs replacement silicone analog controller joystick thumb stick grips cap cover for ps3 / ps4 / xbox 360 / xbox one / wii game controllers (green),0,0,1,1,2,4,4.25
mcbazel replacement xbox controller to pc usb adapter cable [not for xbox 360 or xbox one],1,0,1,0,2,4,3.5
uspro ps3 bluetooth 6 axis wireless game controller gamepad joypad dualshock with charging cable for sony playstation 3,2,0,1,1,0,4,2.25
uspro® ps3 bluetooth 6 axis wireless game controller gamepad joypad dualshock with charging cable for sony playstation 3,1,0,0,2,1,4,3.5
astro gaming halo a50 wireless headset for xbox one (2015 model),1,1,1,0,1,4,2.75
age of empires: gold edition - pc,0,0,1,1,2,4,4.25
madagascar kartz,0,0,0,2,2,4,4.5
halo special edition xbox game system [xbox],1,0,0,0,3,4,4.0
rock candy wired controller for xbox one - blueberry boom,1,0,0,2,1,4,3.5
component cable for av output from sony psp to hdtv,0,0,0,0,4,4,5.0
campfire legends: the hookman [download],0,1,1,1,1,4,3.5
amazing adventures: the caribbean secret - pc,0,0,0,1,3,4,4.75
farming simulator '15 - pc,0,0,1,1,2,4,4.25
tokyo twilight ghost hunters - playstation 3,0,0,0,2,2,4,4.5
fifa 16 & steelbook (amazon exclusive) - playstation 4,0,0,0,0,4,4,5.0
the settlers: rise of an empire - pc,0,1,1,0,2,4,3.75
"hitman trilogy (includes blood money, silent assassins, and contracts) - playstation 2",0,0,0,0,4,4,5.0
burger shop 2 [download],0,0,0,0,4,4,5.0
lego pirates of the caribbean - sony psp,1,1,0,1,1,4,3.0
bass pro shops: the strike - nintendo wii (game only),0,0,0,2,2,4,4.5
the wizard of oz: beyond the yellow brick road nds,0,0,0,2,2,4,4.5
ortz xbox 360 battery pack + free 2x rechargeable batteries with charging station - best quality charger for x360 wireless controller - usb cable & dock stand with 2 batteries - quick charge kit (black) - 1 year warranty,0,0,0,2,2,4,4.5
boogie with microphone - nintendo wii (bundle),0,1,2,0,1,4,3.25
nintendo 2ds sea green (includes mario kart 7),1,0,0,1,2,4,3.75
tak 2 the staff of dreams - gamecube,0,0,0,1,3,4,4.75
nhl 2k10 - xbox 360,0,0,1,1,2,4,4.25
rise of the tomb raider - xbox one digital code,0,1,0,0,3,4,4.25
drawn to life: the next chapter - nintendo wii,0,1,1,0,2,4,3.75
"phantasy star online, episode i & ii",1,0,0,0,3,4,4.0
mvp baseball 2003,0,0,0,1,3,4,4.75
the sims - xbox,0,0,1,2,1,4,4.0
mad catz street fighter v arcade fightstick te2+ for playstation4 and playstation3,0,0,0,0,4,4,5.0
nyko modular power station - 2 port power station with 2 rechargeable batteries for xbox one,0,2,0,1,1,4,3.25
kororinpa: marble mania - nintendo wii,0,0,0,1,3,4,4.75
"gh wii steering wheel for mario kart 8 and other nintendo remote driving games, wii (u) racing wheel for remote plus controller - original white (6 colors available)",0,1,0,0,3,4,4.25
chu chu rocket,1,0,1,1,1,4,3.25
world of tanks [download],1,0,1,0,2,4,3.5
golden trails: the new western rush [download],0,0,0,4,0,4,4.0
ps3 controller charging station,2,1,0,0,1,4,2.25
silicone protective case for controller (black),0,0,0,0,4,4,5.0
south park,0,1,0,0,3,4,4.25
adventure island - nintendo nes,1,0,0,2,1,4,3.5
everquest 2 - pc,1,1,1,0,1,4,2.75
space shooter 3d [download],2,0,1,1,0,4,2.25
tropico 5 - xbox 360,0,0,1,1,2,4,4.25
army men world war,1,0,1,1,1,4,3.25
intellivision lives - nintendo ds,0,1,0,1,2,4,4.0
grip with silicone handles for nintendo 3ds,0,1,1,0,2,4,3.75
ps3 500gb lego: the hobbit bundle,0,0,0,0,4,4,5.0
who wants to be a millionaire 2nd edition cd-rom for pc,0,0,2,2,0,4,3.5
nintendo ds gameboy advance sp replacement ac adapter,0,0,0,1,3,4,4.75
custom metal dark grey thumbsticks grips for ps4 controller,0,0,0,0,4,4,5.0
populous:  the beginning - pc,0,0,1,1,2,4,4.25
street fighter v - playstation 4 standard edition,0,0,0,1,3,4,4.75
hyperkin replacement doors for wii - white,0,0,0,0,4,4,5.0
ps3 fighting stick 3,0,0,1,2,1,4,4.0
xcm x8 unlock tool set for xbox 360 slim,0,0,0,0,4,4,5.0
eye pet and friends - playstation 3,0,1,0,1,2,4,4.0
mlb 07: the show,0,0,0,2,2,4,4.5
frogger,0,0,0,1,3,4,4.75
mahjong escape: ancient china - pc,0,0,0,0,4,4,5.0
natural doctrine - playstation 4,1,2,0,0,1,4,2.5
sega dreamcast controller - blue,0,0,1,0,3,4,4.5
spider-man: the edge of time - nintendo wii,0,0,1,0,3,4,4.5
ps3 s video cable,0,0,0,0,4,4,5.0
"wireless guitar for wii guitar hero and rock band games (excluding rock band 1), color white",0,0,0,2,2,4,4.5
nintendo 3ds silicone protector - black,0,0,0,2,2,4,4.5
barbie groom and glam pups - nintendo wii,0,0,0,1,3,4,4.75
bubble bobble - nintendo nes,0,0,0,0,4,4,5.0
turtle beach - ear force stealth 400 fully wireless gaming headset - ps4 (discontinued by manufacturer),0,0,0,1,3,4,4.75
big city adventure: paris [download],0,0,0,1,3,4,4.75
build-a-bear workshop - nintendo ds,0,0,1,0,3,4,4.5
"nerf armor, blue - nintendo 2ds",0,0,2,1,1,4,3.75
khomo: crystal hard case cover for new nintendo 3ds system,0,0,1,2,1,4,4.0
nintendo 3ds inner earphone - black,0,0,0,2,2,4,4.5
fifa 15 (ultimate edition) - playstation 3,0,0,0,0,4,4,5.0
playstation 3 wwe all stars brawl stick,1,0,1,0,2,4,3.5
namco museum megamix,0,0,0,0,4,4,5.0
black 18 in 1 game & memory card holder case storage box for ps vita (psv),1,0,1,2,0,4,3.0
everquest: the ruins of kunark - pc,0,0,1,2,1,4,4.0
bravely second: end layer collector's edition - nintendo 3ds,1,0,1,0,2,4,3.5
universal av and s video cable,0,0,0,1,3,4,4.75
dark souls ii: collector's edition - pc,0,0,0,0,4,4,5.0
nyko charge link - micro-usb controller charge and sync cable for xbox one,0,0,0,0,4,4,5.0
mobile suit gundam: federation vs. zeon,0,1,0,2,1,4,3.75
aceshot thumb grips (8pc) for playstation 4 by foamy lizard – sweat free 100% silicone precision platform raised anti-slip rubber analog stick thumb grips for ps4 controller (8 grips per order),0,0,0,0,4,4,5.0
"insassy (tm) replacement talkback puck cable for turtle beach earforce x1, x11 and x41 headsets with free insassy stylus",1,0,1,0,2,4,3.5
hori nintendo switch splatoon 2 splat & chat headset,1,0,0,2,1,4,3.5
rift [download],1,1,0,2,0,4,2.75
tnp ps3 component av cable (6 feet) premium high resolution hdtv component rca audio video cable for sony playstation 3 ps3 and playstation 2 ps2 gaming console [playstation 3],0,0,1,0,3,4,4.5
playstation 3 5-in-1 starter kit,0,0,1,1,2,4,4.25
playstation 3 rock band 3 midi pro - adapter,0,0,0,1,3,4,4.75
the movies: premiere edition (dvd) - pc,0,0,2,0,1,3,3.6666666666666665
"elitepro grip studded skin set for xbox one elite controller by foamy lizard ® sweat free silicone skin w/ raised anti-slip studs plus set of 8 qsx-elite thumb grips (skin + qsx-e grips, black)",1,0,0,0,2,3,3.6666666666666665
fifa soccer 07 - xbox 360,0,0,1,1,1,3,4.0
flatout: head on - sony psp,0,0,0,1,2,3,4.666666666666667
dragonshard - pc,1,1,0,1,0,3,2.3333333333333335
disney's high school musical: making the cut - nintendo ds,0,0,1,0,2,3,4.333333333333333
extremerate 60 pcs/set custom game light bar vinyl stickers decal led lightbar cover for playstation 4 dualshock 4 ps4 ps4 slim ps4 pro controller skins,0,0,0,0,3,3,5.0
"mudder mixed colors silicone thumb stick grip caps protect cover for ps4, xbox 360, ps3 controllers, 8 pair",0,0,1,1,1,3,4.0
chuzzle,1,0,0,0,2,3,3.6666666666666665
av cable game cube nintendo 64 super nintendo (bulk packaging),0,0,0,1,2,3,4.666666666666667
disney art academy - nintendo 3ds standard edition,0,0,0,2,1,3,4.333333333333333
ps4 stand - playstation 4 accessories vertical space saving design with 2 cooling fans and ps4 controller charging station for two dualshock 4 controllers get organized with the battle command station,0,0,1,0,2,3,4.333333333333333
unravel - xbox one digital code,0,0,1,1,1,3,4.0
singstar amped (stand alone) - playstation 2,0,0,0,0,3,3,5.0
nyko power cord for ps3 (9 feet),0,0,1,0,2,3,4.333333333333333
air conflicts - pc,1,0,1,0,1,3,3.0
dualshock 4 wireless controller for playstation 4 - gold [import],0,0,0,0,3,3,5.0
xbox one 500gb console - the lego movie videogame bundle,2,0,1,0,0,3,1.6666666666666667
two pack nintendo nes extension cables ( not compatible with nes classic edition ),0,0,0,0,3,3,5.0
guild wars 2: heart of thorns deluxe edition [online game code],1,0,0,1,1,3,3.3333333333333335
powera charging station with elite door for xbox one- black,1,0,0,1,1,3,3.3333333333333335
plants vs. zombies garden warfare 2 - xbox one digital code,0,0,0,0,3,3,5.0
carrier strike force: expansion for microsoft flight simulator x and fs 2004,0,0,0,0,3,3,5.0
shadow the hedgehog - xbox,1,0,1,0,1,3,3.0
midway arcade treasures 3 - playstation 2,0,0,1,1,1,3,4.0
psp playgear amp,0,0,1,1,1,3,4.0
xbox 360 wireless halo 3 headset,0,0,0,0,3,3,5.0
simcity 2000 special edition - pc,0,0,1,2,0,3,3.6666666666666665
"nyko charge block duo -2 port controller charging station with 2 rechargeable batteries, covers and included micro-usb/ac power cord for xbox one",0,0,0,1,2,3,4.666666666666667
sony ps2 memory card - red - 8mb,0,1,0,1,1,3,3.6666666666666665
just dance 2017 - wii u,1,0,0,0,2,3,3.6666666666666665
just dance 2017 - xbox 360,0,0,1,1,1,3,4.0
dungeon siege ii deluxe,0,1,1,1,0,3,3.0
insaniquarium - pc,0,0,0,1,2,3,4.666666666666667
the warriors - sony psp,0,0,0,0,3,3,5.0
ps4 usb hub 5 port usb 3.0 2.0 high speed expansion hub charger controller adapter connector for sony playstation 4 ps4 gaming console [playstation 4],1,0,0,0,2,3,3.6666666666666665
the witcher 3: wild hunt - hearts of stone - playstation 4 [digital code],0,1,0,0,2,3,4.0
nascar sim racing - pc,1,0,1,1,0,3,2.6666666666666665
age of conan: hyborian adventures collector's edition - pc,1,0,2,0,0,3,2.3333333333333335
psp umd tower,0,0,0,1,2,3,4.666666666666667
retro atari classics nds,0,0,0,3,0,3,4.0
star wars: battlefront & steelbook (amazon exclusive) - xbox one,1,0,0,1,1,3,3.3333333333333335
sims 2 - xbox,0,0,0,2,1,3,4.333333333333333
halo 5: guardians - digital deluxe edition - xbox one digital code,1,0,0,0,2,3,3.6666666666666665
the legend of zela video game the legend of zela experience the challenge of endless aventure (nes nitendo 8-bit vieo game cartridge),0,0,0,0,3,3,5.0
component av cable for nintendo wii to hdtv (bulk packaging),0,0,0,0,3,3,5.0
sims 2 - gamecube,0,0,0,0,3,3,5.0
powera charging stand for xbox one - black,1,0,0,1,1,3,3.3333333333333335
gamilys 512mb memory card compatible for wii  gamecube,0,0,0,0,3,3,5.0
rollercoaster tycoon 3: gold compilation pack - pc,0,0,0,1,2,3,4.666666666666667
ncaa football 07 - playstation 2,0,0,1,2,0,3,3.6666666666666665
game of life - pc,0,1,0,2,0,3,3.3333333333333335
civilization iv - mac,0,1,1,1,0,3,3.0
18 wheels of steel: haulin' - pc,0,0,0,0,3,3,5.0
world of warcraft (battle chest box) - pc/mac [digital code] [online game code],1,0,0,0,2,3,3.6666666666666665
guilty gear xx accent core - nintendo wii,0,0,0,1,2,3,4.666666666666667
rayman raving rabbids - xbox 360,0,0,0,2,1,3,4.333333333333333
xbox 360 fighting stick ex 2,0,1,1,0,1,3,3.3333333333333335
yo-kai watch 2: bony spirits - nintendo 3ds,0,0,0,0,3,3,5.0
amiibo shizue [winter clothes (animal crossing series),0,0,0,0,3,3,5.0
sid meier’s civilization vi [online game code],1,0,1,0,1,3,3.0
viva pinata,0,0,1,2,0,3,3.6666666666666665
richen plastic hard skin case cover protector shell for nintendo new 3ds xl ll( kittens),0,0,0,0,3,3,5.0
blueloong ps3 controller wireless double shock 2 pack,1,0,0,0,2,3,3.6666666666666665
blazing angels 2 secret missions of ww ii - pc,1,0,0,1,1,3,3.3333333333333335
sid meiers civilization iv: complete [uk import],0,0,0,0,3,3,5.0
dead or alive xtreme 3 venus (chinese & english subs) for playstation vita [ps vita],0,0,0,1,2,3,4.666666666666667
sudoku mania - nintendo ds,1,0,0,1,1,3,3.3333333333333335
sega bass fishing,0,0,0,0,3,3,5.0
yourself fitness,0,0,0,1,2,3,4.666666666666667
xbox 360 rock band wireless guitar,0,2,0,1,0,3,2.6666666666666665
8bitdo retro receiver - nes,1,0,0,0,2,3,3.6666666666666665
mad catz street fighter v fightpad pro for playstation4 and playstation3 - white,1,0,1,0,1,3,3.0
fire emblem fates: birthright - 3ds [digital code],0,0,0,1,2,3,4.666666666666667
singstar pop bundle (with 2 microphones),0,0,0,1,2,3,4.666666666666667
atv offroad fury pro - sony psp,0,0,0,2,1,3,4.333333333333333
madagascar - gamecube,0,0,1,0,2,3,4.333333333333333
rocket knight adventures,0,0,0,0,3,3,5.0
adjustr volume and mic mute control for ps4,0,0,0,0,3,3,5.0
total annihilation - pc,0,0,0,1,2,3,4.666666666666667
just cause 3 - xbox one digital code,1,0,0,0,2,3,3.6666666666666665
go diego go: safari rescue - nintendo ds,0,0,0,0,3,3,5.0
"3 in 1 ac adaptor - nintendo, super nintendo, genesis",0,0,2,1,0,3,3.3333333333333335
new nintendo 3ds xl hyrule edition,0,0,0,0,3,3,5.0
taiko drum master - playstation 2,0,0,0,3,0,3,4.0
age of empires iii: the warchiefs expansion pack,0,0,1,1,1,3,4.0
pdp legendary collection sound of justice true wireless headset for playstation 4,0,0,0,0,3,3,5.0
ps2 16 meg max memory card,0,0,1,0,2,3,4.333333333333333
nintendo ds (nds) replacement battery,0,0,0,0,3,3,5.0
komodo nintendo gamecube av audio / video/ svideo cable,0,0,0,0,3,3,5.0
puzzle games sudoku edition - nintendo ds,0,0,0,0,3,3,5.0
game boy micro - 20th anniversary edition - game boy advance,0,0,0,0,3,3,5.0
for honor: gold edition (includes extra content + season pass subscription) - xbox one,1,0,0,2,0,3,3.0
astro gaming mixamp pro tr for ps4 - black - playstation 4,0,0,0,1,2,3,4.666666666666667
naruto: clash of ninja,0,0,1,0,2,3,4.333333333333333
ncaa march madness 07 - xbox 360,1,1,0,0,1,3,2.6666666666666665
crash of the titans - playstation 2,1,0,1,0,1,3,3.0
american sniper [download],1,2,0,0,0,3,1.6666666666666667
hori pikachu hard pouch for new nintendo 3ds xl officially licensed by nintendo & pokemon,0,0,0,0,3,3,5.0
hori pokemon ultra sun & ultra moon hard pouch for new nintendo 3ds xl and new nintendo 2ds xl,0,0,0,0,3,3,5.0
driver: parallel lines - nintendo wii,1,0,1,1,0,3,2.6666666666666665
fifa 17 - xbox one,0,0,0,0,3,3,5.0
xbox 360 elite cooling station,0,0,0,1,2,3,4.666666666666667
spellforce 2 - pc,2,0,0,0,1,3,2.3333333333333335
the legend of zelda - 3ds [digital code],0,0,0,0,3,3,5.0
tomee new 3ds xl crystal case with 2 stylus bundle (clear) - nintendo 3ds,0,0,0,1,2,3,4.666666666666667
collective minds xbox one strike pack,0,0,1,1,1,3,4.0
xbox one 1 tb console - ea sports fifa 16 bundle,1,0,0,1,1,3,3.3333333333333335
medieval: total war gold edition - pc,1,0,0,0,2,3,3.6666666666666665
worms: a space oddity - nintendo wii,0,0,1,2,0,3,3.6666666666666665
"talismoon whisper fan for xbox 360, in blue",0,0,1,1,1,3,4.0
justice league heroes - sony psp,0,0,0,2,1,3,4.333333333333333
pacific fighters - pc,0,0,0,1,2,3,4.666666666666667
eastvita®component av cable for nintendo wii to hdtv,0,0,1,0,2,3,4.333333333333333
total war: warhammer [online game code],1,0,0,0,2,3,3.6666666666666665
astro gaming a50 wireless dolby gaming headset - black/blue - playstation 4 + pc,1,0,1,0,1,3,3.0
astro gaming mixamp pro tr for xbox one - white,0,0,1,1,1,3,4.0
gundam breaker (for stockpile),0,0,0,0,3,3,5.0
amiibo link (super smash bros. series),0,0,0,0,3,3,5.0
luxor 5th passage [download],1,1,0,0,1,3,2.6666666666666665
mcbazel rca toslink optical audio cable adapter for xbox 360 & xbox 360 slim,0,0,0,0,3,3,5.0
mahjong cub3d - nintendo 3ds,0,0,1,0,2,3,4.333333333333333
playstation portable limited edition mlb 11 & gran turismo entertainment pack,0,0,0,0,3,3,5.0
playstation 3 ek-3000 stereo gamer headset,0,0,1,0,2,3,4.333333333333333
letters from nowhere 2 [download],0,0,1,0,2,3,4.333333333333333
nyko charge base 3 for ps3,0,0,0,0,3,3,5.0
minute to win it (kinect) - xbox 360,0,0,0,1,2,3,4.666666666666667
letters from nowhere [download],0,0,1,2,0,3,3.6666666666666665
"turtle beach - ear force p12 amplified stereo gaming headset - ps4, ps vita, and mobile devices",0,0,0,1,2,3,4.666666666666667
e-mods gaming® 2x red analog thumbsticks joysticks for xbox one controller,0,0,0,0,3,3,5.0
retro-bit super retrotrio - console - nes/snes/genesis - 3-in-1 system - silver/black,1,0,0,0,2,3,3.6666666666666665
"astro gaming - a40 audio system, white - xbox 360 [2013 model]",1,0,0,0,2,3,3.6666666666666665
transformers: dark of the moon - xbox 360,0,1,1,0,1,3,3.3333333333333335
e-mods gaming® custom metal gold analog thumb stick for xbox one controller,0,0,0,1,2,3,4.666666666666667
women's murder club: little black lies [download],0,0,1,1,1,3,4.0
"hisonders metal magnetic thumbsticks base, joysticks, grip holder replacement for xbox one elite/ xbox one controllers/ xbox one s controller/ ps4 controller",0,0,1,0,2,3,4.333333333333333
nintendo 3ds car charger,0,0,0,1,2,3,4.666666666666667
the sims 3 outdoor living stuff - expansion  [download],0,0,1,0,2,3,4.333333333333333
nancy drew: the haunted carousel,0,0,1,2,0,3,3.6666666666666665
nintendo 3ds protector,0,1,0,1,1,3,3.6666666666666665
pet zombies,0,0,1,1,1,3,4.0
call of duty: advanced warfare - pc [online game code],0,0,1,2,0,3,3.6666666666666665
nhl 15 - xbox 360,0,1,0,1,1,3,3.6666666666666665
2x 6ft usb charger cable cord for sony ps3 controller,0,0,0,1,2,3,4.666666666666667
new gamecube replacement analog cap yellow replaces worn out analog cap on gamecube controller,0,0,1,2,0,3,3.6666666666666665
the curse of silent marshes [download],0,0,2,0,1,3,3.6666666666666665
campfire legends - the babysitter [download],0,0,1,1,1,3,4.0
xbox 360 e 250gb spring value bundle,0,0,0,0,3,3,5.0
xbox 360 hardware repair kit 1 complete screw washer set for x-clamp replacement with xbrdepot stars 900 thermal compound & complimentary deluxe instructional e-manual,0,0,0,2,1,3,4.333333333333333
j stars victory vs,0,1,0,0,2,3,4.0
fall of the new age [download],0,0,0,2,1,3,4.333333333333333
air flo controller for xbox 360 - wired,0,0,0,1,2,3,4.666666666666667
"skque® silicone thumb stick grip cap cover for sony playstation 4 controller, black",0,0,1,0,2,3,4.333333333333333
tv clip for xb one kinect 2.0,1,0,0,0,2,3,3.6666666666666665
2x wired controller usb breakaway cable cord for microsoft xbox 360,0,0,0,0,3,3,5.0
"pritect sensor cover for xbox 360 and windows kinect - privacy, protection, dust",0,0,0,0,3,3,5.0
nba 2k12 (covers may vary),2,0,0,0,1,3,2.3333333333333335
snark busters: all revved up [mac download],0,0,0,0,3,3,5.0
power rangers samurai xbox 360,0,1,0,0,2,3,4.0
power rangers samurai - nintendo wii,0,0,0,0,3,3,5.0
retro link gamecube style usb wired controller,0,0,0,1,2,3,4.666666666666667
powera usb charging cable for playstation 4,0,0,0,1,2,3,4.666666666666667
high heat major league baseball 2003,0,1,1,1,0,3,3.0
christmas stories nutcracker collector's edition hidden object bonus game,0,0,1,0,2,3,4.333333333333333
might & magic heroes collection,0,0,2,0,1,3,3.6666666666666665
farming simulator '14 - playstation vita,0,0,1,1,1,3,4.0
skylanders battlegrounds: mobile starter pack - ios,0,0,1,0,2,3,4.333333333333333
tecmo super bowl,0,0,0,0,3,3,5.0
sid meier's civilization v: the complete edition [online game code],2,0,0,0,1,3,2.3333333333333335
xbox 360 4gb with kinect holiday value bundle (amazon exclusive bonus value),0,0,0,0,3,3,5.0
castlevania: lords of shadow 2 [online game code],0,1,0,1,1,3,3.6666666666666665
xblaze code:embryo - playstation vita,0,0,0,2,1,3,4.333333333333333
xbox one stereo headset,0,0,1,2,0,3,3.6666666666666665
cronus cross-over gaming device,0,1,0,0,2,3,4.0
2 pcs playstation 4 ps4 usb charging charger 5' feet cables cord ps4 dualshock 4 playstation 4 controller [playstation 4] …,1,0,0,0,2,3,3.6666666666666665
big fish: dark parables 4: the final cinderella with bonus - pc,0,0,1,1,1,3,4.0
pro evolution soccer 2015 - xbox one,0,0,1,0,2,3,4.333333333333333
hidden mysteries: salem secrets,0,2,0,1,0,3,2.6666666666666665
nintendo 64 wired controller,0,0,1,0,2,3,4.333333333333333
hde headset for xbox 360 consoles and live service headphones with microphone for game chat compatible with wireless controllers,0,0,1,1,1,3,4.0
spider-man: shattered dimensions - nintendo ds,0,0,0,0,3,3,5.0
martian panic - nintendo wii,0,0,0,0,3,3,5.0
fps freek cqc performance thumbsticks for playstation 4 controller (ps4),0,0,0,0,3,3,5.0
cronusmax (new version),2,0,1,0,0,3,1.6666666666666667
eforcity® rca audio cable adapter compatible with xbox 360 + slim,0,0,0,1,2,3,4.666666666666667
silent hunter 5: battle of the atlantic gold edition  [download],0,1,0,0,2,3,4.0
nintendo dsi - crystal case plus xl,0,0,1,1,1,3,4.0
pure hidden - pc,0,0,0,1,2,3,4.666666666666667
xbox 360 composite audio/video cable,0,0,0,0,3,3,5.0
rocky,0,1,0,0,2,3,4.0
rhem 4 - pc,1,0,0,1,1,3,3.3333333333333335
wii energizer flat panel 2x induction charger,0,0,0,0,3,3,5.0
command and conquer generals deluxe edition (uk),0,0,0,1,2,3,4.666666666666667
the sims 3 late night - expansion pack [online game code],0,0,0,1,2,3,4.666666666666667
hello kitty party,0,0,0,2,1,3,4.333333333333333
shining force ii,0,0,0,0,3,3,5.0
tritton triax-180 ax 180 stereo gaming headset for xbox 360 and playtation 3,1,0,0,1,1,3,3.3333333333333335
ttx snes - controller - wired - super famicom style - grey - retail packaging,0,0,0,1,2,3,4.666666666666667
where the wild things are - nintendo wii,0,1,1,0,1,3,3.3333333333333335
gamilys replacement ac power adapter for the nintendo gamecube system,0,0,0,0,3,3,5.0
double play: jewel quest 2 and 3 [download],1,0,1,0,1,3,3.0
tekken 6 limited edition wireless fight stick bundle - playstation 3,0,0,1,0,2,3,4.333333333333333
jillian michaels fitness ultimatum 2010 - nintendo wii,0,0,1,0,2,3,4.333333333333333
"star wars: the old republic - 14,500 cartel coins + exclusive item [online game code]",0,0,0,0,3,3,5.0
karaoke revolution bundle - nintendo wii,0,0,0,1,2,3,4.666666666666667
skullcandy slyr xbox one - black/green,0,0,0,1,2,3,4.666666666666667
afterglow aw.1 remote for wii - green,0,1,1,0,1,3,3.3333333333333335
theatre of the absurd: a scarlet frost mystery [download],0,0,0,1,2,3,4.666666666666667
dragon ball z: tenkaichi tag team - sony psp,0,1,0,1,1,3,3.6666666666666665
xbox 360 energizer power and play charging system - black,1,0,0,1,1,3,3.3333333333333335
ride'em low - free demo [download],0,1,0,1,1,3,3.6666666666666665
barbie groom and glam pup - nintendo ds,0,0,0,1,2,3,4.666666666666667
tomee av cable for gamecube/ n64/ snes,1,0,0,0,2,3,3.6666666666666665
zettaguard dual charging station - white - nintendo wii,0,0,0,0,3,3,5.0
insten clear crystal case compatible with sony psp,0,1,0,0,2,3,4.0
freespace 2: sci-fi sim of the year,0,0,0,1,2,3,4.666666666666667
women's murder club: twice in a blue moon [download],0,0,1,2,0,3,3.6666666666666665
nora roberts vision in white [download],0,0,0,2,1,3,4.333333333333333
cake mania: main street - nintendo ds,0,1,0,0,2,3,4.0
vampire moon: mystery of the hidden sun - nintendo ds,0,1,0,2,0,3,3.3333333333333335
nes retro entertainment system - white/red,0,0,0,2,1,3,4.333333333333333
xbox 360 rechargeable controller battery pack pink 2 pack,0,0,1,0,2,3,4.333333333333333
close combat 4: the battle of the bulge - pc,0,1,1,1,0,3,3.0
nhl slapshot bundle - nintendo wii,0,0,0,3,0,3,4.0
disney infinity: marvel super heroes (2.0 edition) video game starter pack - xbox one,0,1,1,1,0,3,3.0
megamind - the blue defender - nintendo ds,0,0,0,2,1,3,4.333333333333333
de blob 2 - xbox 360,1,0,0,0,2,3,3.6666666666666665
rock band 3 wireless keyboard for wii and wiiu,0,0,0,1,2,3,4.666666666666667
sesame street: cookie's counting carnival - nintendo wii,0,0,0,3,0,3,4.0
dj hero 2 software - xbox 360 (stand-alone software),0,0,0,2,1,3,4.333333333333333
cta digital wii sports resort 8-in-1 sports pack (black),0,0,0,1,2,3,4.666666666666667
wwe smackdown vs. raw 2011 - sony psp,0,0,0,0,3,3,5.0
luxor adventures [download],0,0,0,1,2,3,4.666666666666667
metropolismania,0,0,0,0,3,3,5.0
the tomorrow war demo [download],1,0,0,1,1,3,3.3333333333333335
street fighter ex 2 plus,0,0,0,0,3,3,5.0
fallout 3 [online game code],0,0,0,1,2,3,4.666666666666667
astro gaming a50 xbox one - black (2014 model),0,0,0,2,1,3,4.333333333333333
skylanders giants single character pack core hot dog,0,0,0,1,2,3,4.666666666666667
hde av cable for sega saturn gold plated replacement audio and video cable cord tv connector (6 foot),0,0,0,0,3,3,5.0
pro controller u for wii and wii u - white,1,0,1,1,0,3,2.6666666666666665
wii u microphone,1,0,0,1,1,3,3.3333333333333335
power jack socket dock connector charger charging port nintendo 3ds replacement,0,0,0,0,3,3,5.0
hde controller adapter playstation 2 to usb for sony playstation 3 and pc converter cable for use with dualshock 2 ps2 wired controllers,0,0,1,1,1,3,4.0
command and conquer the ultimate collection,1,0,0,1,1,3,3.3333333333333335
star trek: armada 2 (jewel case) - pc,0,0,0,2,1,3,4.333333333333333
i am alive [download],0,2,1,0,0,3,2.3333333333333335
mortal kombat arcade kollection [download],0,0,1,1,1,3,4.0
namco museum vol. 1 (playstation),0,0,0,2,1,3,4.333333333333333
power a skylanders carry & display case,0,0,0,0,3,3,5.0
insten 1 set top/ bottom lcd screen protector compatible with nintendo new 3ds xl / new 3ds ll / 3ds xl / 3ds ll,0,0,0,1,2,3,4.666666666666667
la noire - complete edition [download],0,2,0,0,1,3,3.0
tom clancy's ghost recon future soldier - deluxe edition [online game code],1,1,0,0,1,3,2.6666666666666665
nintendo 3ds ll charging stand,0,0,0,0,3,3,5.0
finding nemo: escape to the big blue special edition - nintendo 3ds,0,0,0,1,2,3,4.666666666666667
monster high: skultimate roller maze - nintendo wii,0,0,1,1,1,3,4.0
barbie dreamhouse party - nintendo wii u,0,1,0,1,1,3,3.6666666666666665
zumba fitness world party - xbox 360,0,0,1,0,2,3,4.333333333333333
pdp battlefield 4 wired controller - xbox 360,1,0,0,1,1,3,3.3333333333333335
rise of the guardians: the video game - nintendo ds,0,0,0,0,3,3,5.0
moshi monsters moshlings theme park - nintendo 3ds,0,0,0,0,3,3,5.0
ps3 fighting stick mini 3,0,0,0,1,2,3,4.666666666666667
frogger's adventures: temple of the frog,0,0,1,1,1,3,4.0
capcom essentials,0,0,0,2,1,3,4.333333333333333
tom clancy's splinter cell blacklist deluxe edition [download],0,0,0,1,2,3,4.666666666666667
worms world party - pc,0,0,0,0,3,3,5.0
[upgraded version]ultra-comfort white & red wireless bluetooth ps3 controller for the playstation 3 console by avalid,0,0,1,0,2,3,4.333333333333333
2400 g1 credits: apb reloaded [instant access],0,0,1,1,1,3,4.0
sony playstation 3 dualshock 3 controller - black,1,0,0,1,1,3,3.3333333333333335
xbox 360 wireless controller (white),0,0,1,0,2,3,4.333333333333333
donop wireless usb gaming receiverfor xbox 360 controller to pc(white),1,0,0,0,2,3,3.6666666666666665
necronomicon - pc,0,0,2,0,1,3,3.6666666666666665
besdata ultra high capacity 2-pack 4800mah rechargeable batteries & usb charging cable for xbox 360 wireless controller - perfect for replacement - w0051 [xbox 360],0,0,0,1,2,3,4.666666666666667
the sims 3 starter pack - pc/mac,0,0,0,0,3,3,5.0
digimon world 2,0,0,0,0,3,3,5.0
"skullcandy plyr1 7.1 surround sound wireless gaming headset, white (smpyfy-072)",1,0,1,0,1,3,3.0
gaems vanguard personal gaming environment (xbox 360/ ps3 not included),0,0,0,1,2,3,4.666666666666667
sid meier's civilization v: gold edition [online game code],1,0,0,1,1,3,3.3333333333333335
2k sports combo pack - mlb2k13/nba2k13 - playstation 3,0,0,1,1,1,3,4.0
sony psp system pouch,0,0,0,1,2,3,4.666666666666667
hooddeal 10pcs plastic cartridge cases for gba gba sp gbm gameboy advance,0,0,0,1,2,3,4.666666666666667
defiance [download],0,1,1,0,1,3,3.3333333333333335
baldur's gate enhanced edition [online game code],0,1,0,0,2,3,4.0
gamecap hd recorder - playstation 3/xbox 360/psp,1,0,1,1,0,3,2.6666666666666665
bestsupply classic controller pro for nintendo wii (2 pieces) - black,0,0,0,1,2,3,4.666666666666667
starcraft with brood war expansion pack,0,0,0,2,1,3,4.333333333333333
ftl: faster than light [online game code],0,1,0,1,1,3,3.6666666666666665
call of duty 4: modern warfare [download],0,0,0,1,2,3,4.666666666666667
full throttle,0,0,0,2,1,3,4.333333333333333
charge adaptor for wii u,0,0,0,1,2,3,4.666666666666667
fifa 14 [online game code],1,0,1,0,1,3,3.0
alice: madness returns the complete collection [download],0,0,0,0,3,3,5.0
"insten for nintendo switch network adapter, usb 2.0 to 10/100 mbps fast rj45 lan ethernet wired internet adapter compatible with nintendo switch/ wii/ wii u gaming connection hub macbook chromebook",0,0,0,1,2,3,4.666666666666667
bomberman tournament,0,0,0,1,2,3,4.666666666666667
bioshock [download],0,0,0,1,2,3,4.666666666666667
hatsune miku: project diva f [japanese import] ps vita,0,0,0,0,3,3,5.0
nickelodeon dance - nintendo wii,0,0,0,1,2,3,4.666666666666667
tony hawk's pro skater 2,0,0,0,0,3,3,5.0
4 elements 2 [download],0,0,2,0,1,3,3.6666666666666665
the amazing spider-man 2 - nintendo 3ds,0,1,0,0,2,3,4.0
"5000mah li-ion extended battery with cover for nintendo 3ds, n3ds, ctr-001, min-ctr-001",0,1,0,0,2,3,4.0
carnival games wild west 3d - nintendo 3ds,0,0,2,0,1,3,3.6666666666666665
a-10c warthog - pc,1,0,0,0,2,3,3.6666666666666665
margrave: the curse of the severed heart [download],0,0,0,1,2,3,4.666666666666667
hori ps3 tactical assault commander 3 (t.a.c.) for fps games (camouflage version),1,0,0,1,1,3,3.3333333333333335
pdp energizer 2x charging system - nintendo wii,0,1,1,0,1,3,3.3333333333333335
haobase 3 x analog joystick stick cap cover button for psp 1000 [sony psp],0,0,0,0,3,3,5.0
3 pcs silver tone black plastic stylus for nintendo 3ds,0,0,0,1,2,3,4.666666666666667
cabela's big game hunter hunting party with gun - xbox 360,0,1,1,0,1,3,3.3333333333333335
the sims medieval: pirates and nobles expansion [download],0,0,2,1,0,3,3.3333333333333335
assassin's creed iv black flag - ps3 [digital code],0,0,0,0,3,3,5.0
assassin's creed iv black flag limited edition -xbox 360,0,0,0,1,2,3,4.666666666666667
orb controller thumb grips 2-pack (xbox one),0,0,0,0,3,3,5.0
factop xbox360 controller blue white camo silicone case cover skin,0,1,0,0,2,3,4.0
pythons protective case for sony playstation 4 ps4 controller-black,0,0,0,0,3,3,5.0
pdp 360 energizer charger with battery - xbox 360,0,0,0,0,3,3,5.0
top gun hardlock - xbox 360,0,0,0,1,2,3,4.666666666666667
cabela's adventure camp - nintendo wii,0,0,0,0,3,3,5.0
monster high: ghoul spirit - nintendo ds,0,0,1,0,2,3,4.333333333333333
beyond atlantis - pc,0,1,0,2,0,3,3.3333333333333335
monster rancher advance,0,0,0,1,2,3,4.666666666666667
the attic - hidden object game [download],0,1,0,1,1,3,3.6666666666666665
"hde custom replacement wireless game controller shell case cover kit for xbox 360 - includes button set, torx & phillips head screwdrivers (gold)",0,0,0,0,3,3,5.0
team umizoomi - nintendo ds,0,0,0,1,2,3,4.666666666666667
mystic diary: haunted island,0,0,1,0,2,3,4.333333333333333
mortimer beckett and the crimson thief - premium edition [download],0,0,1,0,2,3,4.333333333333333
battlefield 3 - limited edition - preload available [download],1,0,1,0,1,3,3.0
gioteck ex3-r inline messenger headset - playstation 4,0,0,1,2,0,3,3.6666666666666665
polk audio n1 39-inch bluetooth gaming soundbar,0,0,1,0,2,3,4.333333333333333
tropico 4 gold edition - xbox 360,0,0,1,0,2,3,4.333333333333333
wipeout: create & crash - nintendo 3ds,0,0,0,1,2,3,4.666666666666667
"cosmos ® light blue protection hard case cover for playstation ps vita 1000, fits for oval start & select button only, with lcd touch screen cleaning cloth",0,0,0,1,2,3,4.666666666666667
fifa soccer 2002,0,0,1,0,2,3,4.333333333333333
amerzone - pc,0,0,0,3,0,3,4.0
youda mystery: the stanwick legacy [download],0,0,2,0,1,3,3.6666666666666665
zettaguard dual usb charger station dock for sony ps3 controller,0,0,1,1,1,3,4.0
cta digital ps vita 25 in 1 luxury kit,0,0,1,0,2,3,4.333333333333333
disney infinity power disc rapunzel's kingdom,0,0,1,0,2,3,4.333333333333333
white built-in motion plus wii remote + nunchuck controller(wii controller) for wii (non-oem)+ silicone case + wrist strap (white),0,0,0,0,3,3,5.0
battleship - nintendo 3ds,0,0,0,0,3,3,5.0
lego batman 2: dc super heroes - pc,0,0,0,1,2,3,4.666666666666667
x-plane 10 global flight simulator (pc & mac),1,0,0,0,2,3,3.6666666666666665
pickers [download],1,0,0,1,1,3,3.3333333333333335
skylanders spyros adventure loose mini figure spyro bronze wings includes online code,0,0,0,0,3,3,5.0
tiger woods pga tour 13: the masters collector's edition - playstation 3,0,0,1,2,0,3,3.6666666666666665
insten compatible with sony psp 1000 1001 high capacity 1800mah battery us (not compatible with psp-2000 or 3000),0,0,1,1,1,3,4.0
mad catz offically licensed major league gaming pro circuit mlg controller for playstation 3,2,1,0,0,0,3,1.3333333333333333
deadliest warrior: ancient combat - xbox 360,1,0,0,2,0,3,3.0
kontrol freek thumb stick addon elite- black (xbox 360),0,1,0,0,2,3,4.0
kontrol freek thumb stick addon ultrax 360 black (xbox 360),0,0,1,0,2,3,4.333333333333333
the amazing spider-man - nintendo ds,0,0,0,1,2,3,4.666666666666667
nintendo gamecube console - indigo with 3 games,1,0,2,0,0,3,2.3333333333333335
civilization iii and iv complete,1,0,1,0,1,3,3.0
hidden mysteries: titanic - nintendo wii,0,0,3,0,0,3,3.0
phantasy star universe - playstation 2,1,0,0,1,1,3,3.3333333333333335
tom clancy's h.a.w.x. 2,0,0,0,2,1,3,4.333333333333333
ncaa football 10 - playstation 2,0,1,0,1,1,3,3.6666666666666665
classic controller for super nintendo,0,0,0,0,3,3,5.0
dream day first home - pc,0,0,0,1,2,3,4.666666666666667
grand theft auto v - xbox one [digital code],0,0,0,0,3,3,5.0
sebastien loeb rally evo - xbox one,0,0,0,2,1,3,4.333333333333333
r.u.s.e. [download],0,0,0,2,1,3,4.333333333333333
2 2800 battery+dual remote controller charger for wii [nintendo wii],1,0,0,2,0,3,3.0
battlelost [download],2,0,0,0,1,3,2.3333333333333335
world of goo [online game code],0,0,0,1,2,3,4.666666666666667
super smash bros. melee,0,1,0,0,2,3,4.0
xcm cross battle adapter plus rumble,0,0,2,0,1,3,3.6666666666666665
guitar hero live - playstation 3,0,0,0,1,2,3,4.666666666666667
lips - xbox 360,0,0,0,3,0,3,4.0
4 pairs of replacement joystick thumbstick thumb stick for playstation 4 ps4 controller,1,0,0,1,1,3,3.3333333333333335
scuf fps adjustable trigger & pro grip combo kit - xbox one compatible (black),0,0,0,0,3,3,5.0
battlestations pacific - xbox 360,1,0,0,1,1,3,3.3333333333333335
ea sports active accessory pack,0,0,0,1,2,3,4.666666666666667
4 elements [download],0,0,0,1,2,3,4.666666666666667
scene it? box office smash bundle - xbox 360,0,0,0,0,3,3,5.0
nintendo 2ds - crystal red,0,0,0,0,3,3,5.0
top spin 3 - nintendo wii,0,0,1,2,0,3,3.6666666666666665
imagine: family doctor,0,1,0,0,2,3,4.0
wordmaster - nintendo ds,0,0,2,0,1,3,3.6666666666666665
ac/dc live: rock band track pack - playstation 3,0,0,1,0,2,3,4.333333333333333
taketwo interactive fallout 3 [playstation 3] [playstation 3],0,0,2,1,0,3,3.3333333333333335
microsoft 3m6-00052 xbox 360 500gb console blue,1,0,1,0,1,3,3.0
top spin,0,0,0,3,0,3,4.0
art of murder: fbi confidential - pc,0,1,2,0,0,3,2.6666666666666665
everlast boxing gloves - nintendo wii,0,0,0,0,3,3,5.0
nintendo ds lite limited edition ice blue with brain age: train your brain in minutes a day! and carrying case bundle,0,0,0,0,3,3,5.0
guitar hero van halen - playstation 2,0,1,0,1,1,3,3.6666666666666665
hotel giant 2 - pc,0,0,1,2,0,3,3.6666666666666665
assassin’s creed syndicate - gold edition - pc,1,0,0,0,2,3,3.6666666666666665
madden nfl 10 - sony psp,0,0,0,1,2,3,4.666666666666667
the crystal key - pc/mac,0,2,1,0,0,3,2.3333333333333335
dirt 2 - pc,1,0,0,1,1,3,3.3333333333333335
heroes of the storm - pc/mac,0,0,0,0,3,3,5.0
simcity creator - nintendo ds,0,0,1,0,2,3,4.333333333333333
build-a-lot - pc,0,2,0,0,1,3,3.0
sony ps3 street fighter iv fightstick,0,0,2,1,0,3,3.3333333333333335
hori dual charger for xbox one with two rechargable battery packs,0,0,1,0,2,3,4.333333333333333
ps3 media hub +,1,0,0,0,2,3,3.6666666666666665
volume 1 adventure collection,0,0,0,1,2,3,4.666666666666667
kontrolfreek performance grips for xbox one controller,0,1,0,1,1,3,3.6666666666666665
new 16mb memory card for wii (console gamecube),0,0,0,0,3,3,5.0
paperboy 2,0,0,0,2,1,3,4.333333333333333
buzz junior: robo jam bundle - playstation 2,0,0,0,0,3,3,5.0
tachyon: the fringe,0,0,0,2,1,3,4.333333333333333
up - nintendo ds,0,0,0,0,3,3,5.0
hideit 4 mount (black) - original ps4 wall mount - made in the usa,0,0,0,1,2,3,4.666666666666667
lego ninjago: shadow of ronin - nintendo 3ds,0,0,0,0,3,3,5.0
feeding frenzy 2: shipwreck showdown,0,0,0,0,3,3,5.0
6ft. hd component cable for nintendo wii (bulk packaging),0,0,0,0,3,3,5.0
rock band bass pedal repair - pedal metal billet with hinge - factory blemished - please read product description,0,0,0,0,3,3,5.0
2 pairs l2 r2 trigger springs replacemnet parts buttons for playstation 4 ps4 controller dualshock 4 everyone-buy,0,0,0,0,3,3,5.0
nintendo ds star wars light up lightsaber stylus 2 pack,0,0,0,1,2,3,4.666666666666667
legend of spyro: dawn of the dragon - playstation 2,1,0,0,1,1,3,3.3333333333333335
nightlong: union city conspiracy,0,1,0,1,1,3,3.6666666666666665
nhl 09 - pc,0,1,1,0,1,3,3.3333333333333335
sony playstation 3 (ps3) move motion controller (certified refurbished),0,0,0,0,3,3,5.0
wii fit starter bundle 6-in-1,0,0,1,0,2,3,4.333333333333333
samantha swift and the hidden roses of athena,1,0,0,2,0,3,3.0
psp invisi-shield,0,0,2,0,1,3,3.6666666666666665
hasbro family game night 2 - nintendo wii,0,0,0,0,3,3,5.0
espn nba basketball,0,0,1,0,2,3,4.333333333333333
nba jam t.e. tournament edition,1,0,0,1,1,3,3.3333333333333335
psvita2000 l2/r2button load grip cover black,0,0,1,1,1,3,4.0
chronicles of mystery: the scorpio ritual - pc,0,2,0,1,0,3,2.6666666666666665
ostent wired controller gamepad joystick joypad for nintendo 64 n64 console video games – black,0,0,0,1,2,3,4.666666666666667
turtle beach - ear force recon 50x stereo gaming headset - xbox one (compatible w/ xbox one controller w/ 3.5mm headset jack) and ps4,1,0,0,1,1,3,3.3333333333333335
skylanders trap team nitro krypt king,0,0,0,0,3,3,5.0
kontrolfreek alpha - xbox one,0,1,1,0,1,3,3.3333333333333335
halo: the master chief collection - xbox one digital code,0,0,0,0,3,3,5.0
gamecube extension cable (colors may vary) (bulk packaging),0,1,0,0,2,3,4.0
"mudder silicone thumb stick grips caps protect cover for ps4, xbox 360, ps3 controllers, mixed color(set of 10)",0,0,1,0,2,3,4.333333333333333
pac-man amiibo - japan import (super smash bros series),0,0,0,0,3,3,5.0
ps3 turbo shock iii wireless controller,0,0,0,2,1,3,4.333333333333333
collective minds chatboost chat pad with battery pack,1,0,0,0,2,3,3.6666666666666665
armored core: for answer - xbox 360,0,0,0,0,3,3,5.0
transformers: revenge of the fallen - playstation 2,0,1,0,0,2,3,4.0
big city adventure: istanbul [download],0,0,0,1,2,3,4.666666666666667
ps3 ezpak extreme,0,0,0,0,3,3,5.0
playstation 3 hardwear controller armor,0,0,0,0,3,3,5.0
"hyperkin polygon ""the rook"" travel bag for xbox one",0,0,0,0,3,3,5.0
nascar 09 - playstation 2,0,0,0,0,3,3,5.0
galactic civilizations ii ultimate edition - pc,1,1,0,0,1,3,2.6666666666666665
rubbercoated grip (new for 3ds ll) black cybergadget [japan import],0,0,1,1,1,3,4.0
the witcher 3: wild hunt - expansion pass - playstation 4 [digital code],0,0,0,0,3,3,5.0
all star cheer squad - nintendo wii,0,2,0,0,1,3,3.0
ps3 guitar hero 5 guitar bundle,1,0,0,0,2,3,3.6666666666666665
cyber premium slide pad cover new 3ds / new 3ds ll / 3ds ll /3ds clear black,2,0,0,0,1,3,2.3333333333333335
ps3 shadow wireless controller with rumble,1,0,1,0,1,3,3.0
j-stars victory vs+ - playstation 3,0,1,0,0,2,3,4.0
nintendo 64 controller - blue,0,0,0,1,2,3,4.666666666666667
kontrolfreek performance grips for playstation 4 controller (ps4),2,0,0,1,0,3,2.0
the sims 4:  perfect patio stuff [online game code],0,0,0,0,3,3,5.0
xbox 360 ghost case - crystal clear/hdmi/blue lights,0,0,0,2,1,3,4.333333333333333
wii frontman wireless guitar - white,0,0,0,2,1,3,4.333333333333333
playstation 3 real arcade pro. 3 fighting stick,0,0,0,1,2,3,4.666666666666667
ps3/ps4 to xbox one controller adapter,0,0,0,0,3,3,5.0
wii energy pak for wii balance board,0,0,0,0,3,3,5.0
"premium high resolution av cable for playstation 3 ps3, playstation 2 ps2",0,0,0,0,3,3,5.0
theresia - nintendo ds,0,0,0,1,2,3,4.666666666666667
saints row 2 collector's edition -xbox 360,0,0,2,0,1,3,3.6666666666666665
battlestations pacific - pc,0,0,0,1,2,3,4.666666666666667
gen rapid home travel charger (110-240v) 3ds/3dsll/ndsi/ndsill,0,0,0,0,3,3,5.0
we love golf! - nintendo wii,1,0,0,2,0,3,3.0
world of warcraft: wrath of the lich king collector's edition,0,0,1,0,2,3,4.333333333333333
skylanders superchargers starter pack - xbox one,0,0,0,0,3,3,5.0
nintendo 64 gameshark,1,0,0,0,2,3,3.6666666666666665
the heroes [download],1,1,1,0,0,3,2.0
dual glow sabers - nintendo wii,1,0,0,1,1,3,3.3333333333333335
cake mania in the mix - nintendo wii,0,1,1,1,0,3,3.0
big kahuna reef 3   [download],0,0,0,1,1,2,4.5
"tzou wii nunchuk / nunchuck controller, pink",0,0,0,0,2,2,5.0
sminiker professional xbox one controller battery pack & charger cable - rechargeable 1200mah battery pack + play kit with 3 meter usb charging cable for xbox one controller(black),0,0,0,0,2,2,5.0
ultimate combo pack - ratchet & clank collection & black dualshock 3 - playstation 3,0,0,0,0,2,2,5.0
"activision skylanders giants triple pack #6 (eruptor, stealth elf & terrafin)",0,0,0,0,2,2,5.0
defiance - pc,1,0,0,1,0,2,2.5
"ketofa 10 pack genuine replacement square drive belts for xbox 360 optical dvd drive repair stuck tray (sbs square type, bulk lot of 10 belts)",0,0,1,0,1,2,4.0
mystery legends phantom of opera - pc,0,0,0,0,2,2,5.0
race pro - xbox 360,0,0,0,1,1,2,4.5
country dance 2 - nintendo wii,0,0,0,0,2,2,5.0
command & conquer: tiberian sun - pc,0,0,1,0,1,2,4.0
psp double life 3600mah battery twice 1800mah life,0,1,1,0,0,2,2.5
the sims 4 [instant access],0,0,2,0,0,2,3.0
econoled wired usb controller for pc & xbox 360 (white),0,0,0,0,2,2,5.0
xbox 360 mini pro ex controller (wired) - smoke,0,0,0,0,2,2,5.0
atv thunder ridge riders / monster trucks mayhem,0,0,0,0,2,2,5.0
sony ps vita senran kagura shinovi versus shoujotachi no shoumei,0,0,0,0,2,2,5.0
work pack - 3 in 1 - hidden object game [download],0,0,0,1,1,2,4.5
battle of giants: dinosaurs - nintendo ds,0,0,0,0,2,2,5.0
jane's hotel - pc,0,2,0,0,0,2,2.0
pandaren ps4 console full skin sticker faceplates (psone style grey skin x 1 + controller skin x 2),1,0,0,0,1,2,3.0
kontrolfreek fps infinity,0,0,0,0,2,2,5.0
nyko type pad - bluetooth mini wireless chat pad message keyboard with built-in speaker and 3.5mm jack for playstation dualshock 4 controller,0,0,0,0,2,2,5.0
playstation 2 component av cable,0,0,1,0,1,2,4.0
the sims 3: town life stuff [download],0,0,0,0,2,2,5.0
battlefield 4 - ps3 [digital code],1,0,0,0,1,2,3.0
c-130 hercules x expansion for ms flight simulator x - pc,0,0,0,0,2,2,5.0
gamergrip - total grip solution - stops sweat on hands for up to 4 hours,0,0,1,0,1,2,4.0
risk/battleship/clue,1,0,0,0,1,2,3.0
can you see what i see?: curfuffles collectibles,0,0,0,1,1,2,4.5
family feud 2012 - nintendo wii,0,0,1,0,1,2,4.0
dance dance revolution regular dance pad for sony playstation2 ps/ps2,1,0,0,1,0,2,2.5
"for ps4 controller silicone skin case cover, insten silicone controller skin case compatible with sony playstation 4 ps4 controller, blue",0,0,0,0,2,2,5.0
snoopy's grand adventure - nintendo 3ds,0,0,0,2,0,2,4.0
dishonored definitive edition pc [online game code],0,0,0,1,1,2,4.5
kinect penguins of madagascar: dr. blowhole returns again! - xbox 360,0,1,0,0,1,2,3.5
udraw marvel super hero squad: comic combat - xbox 360,0,1,0,0,1,2,3.5
microsoft xbox 360 special edition chrome series wireless controller - blue,0,0,1,0,1,2,4.0
xbox 360 live camera bundle,0,0,0,1,1,2,4.5
hde replacement shell for xbox 360 wireless controllers includes shell buttons thumbsticks torx screwdriver replacement case cover and tool kit - red,0,0,0,0,2,2,5.0
big city adventure: rio de janeiro [download],0,0,0,2,0,2,4.0
the chronicles of narnia: prince caspian - nintendo wii,0,0,0,2,0,2,4.0
insten black dual battery charger charging station compatible with xbox360,0,0,0,0,2,2,5.0
high performance thermal pad for playstation 3,0,0,0,2,0,2,4.0
3 great hidden object games! mystery of mortlake mansion + spirit of wandering: the legend + elementals: the magic key,0,0,1,0,1,2,4.0
port royale 3 [download],1,1,0,0,0,2,1.5
"evolved dimensions (formerly true depth 3d) bt motion wireless bluetooth gamepad for android smartphones, cell phones, tablets and devices",0,0,0,1,1,2,4.5
tomee ac adapter for ps vita,0,0,0,0,2,2,5.0
spongebob squarepants: plankton's robotic revenge - nintendo 3ds,0,0,0,0,2,2,5.0
power a xbox 360 medal of honor warfighter edition air flo controller,0,0,0,1,1,2,4.5
"amazing hidden object games 3 pack. paranormal mysteries, immortal lovers, ghost whisperer forgotten toys and sinister city",0,0,1,1,0,2,3.5
guitar hero aerosmith wireless bundle - playstation 3,0,0,0,0,2,2,5.0
amllbo [aori/fire fly] (splatoon series)nintendo wiiu/ 3ds,1,0,0,0,1,2,3.0
the sims 4 dine out [online game code],0,1,0,0,1,2,3.5
clear hard cover for nintendo 3ds ll yawa tpu official licensed products for nintendo 3ds ll [],0,0,0,1,1,2,4.5
the xcom collection [online game code],1,0,0,0,1,2,3.0
wargame: european escalation [download],0,0,0,1,1,2,4.5
power a medal of honor warfighter edition air flo controller for ps3,0,0,0,0,2,2,5.0
tomb raider super bundle (pc dvd) (uk import),0,0,0,0,2,2,5.0
dangerous waters - pc,1,0,0,0,1,2,3.0
astro gaming - a50 wireless headset [2013 model],0,0,0,1,1,2,4.5
cta digital ps vita screen protection kit,2,0,0,0,0,2,1.0
nba 2k16 - playstation 3,1,0,0,0,1,2,3.0
batman: arkham knight - premium edition - playstation 4 [digital code],0,0,0,0,2,2,5.0
sennheiser u 320 multi-platform gaming headset,0,0,0,1,1,2,4.5
hydra performance wired xbox controller game pad s-type - blue,0,0,0,0,2,2,5.0
rollercoaster tycoon deluxe: rollercoaster tycoon / loopy landscapes / corkscrew follies,0,0,0,0,2,2,5.0
everquest: the scars of velious - pc,0,0,0,0,2,2,5.0
dark souls 2 [online game code],0,0,0,1,1,2,4.5
multi-out audio visual a/v cord cable tv connection (bulk packaging),0,0,0,0,2,2,5.0
hori xbox 360 real arcade pro vx sa kai,0,0,0,0,2,2,5.0
the sims 3 plus supernatural,0,0,1,0,1,2,4.0
fifa soccer 13 [download],0,0,0,1,1,2,4.5
ttx tech controller - nintendo wii - white,0,0,1,0,1,2,4.0
playstation 2 ddr dance pad,1,0,1,0,0,2,2.0
mayflash wii/ps3 vga hdtv av cable,0,2,0,0,0,2,2.0
gamilys replacement wii fit rechargeable battery pack & cable,2,0,0,0,0,2,1.0
fifa 17 deluxe edition - playstation 4,0,0,0,0,2,2,5.0
dark dimensions: wax beauty - pc,0,0,0,1,1,2,4.5
command & conquer the ultimate collection [instant access],0,0,1,0,1,2,4.0
flatout 2 - playstation 2,0,0,0,0,2,2,5.0
dungeon runners - pc,0,0,2,0,0,2,3.0
star wars galaxies: jump to lightspeed expansion pack - pc,2,0,0,0,0,2,1.0
tomb raider iii: adventures of lara croft,0,0,0,0,2,2,5.0
zapper gun wii zapper gun wii blaster zapper gun [video game],0,0,0,0,2,2,5.0
xbox live 3 month gold membership + 1 bonus month [online game code],0,0,0,0,2,2,5.0
just dance disney party 2 - wii u standard edition,0,0,0,0,2,2,5.0
"super mario character multi system styluses, 4 pack - nintendo 3ds (discontinued by manufacturer)",0,0,0,0,2,2,5.0
nyko playpad for android/bluetooth (white),0,1,0,0,1,2,3.5
soul calibur v collector's edition -xbox 360,1,0,0,1,0,2,2.5
silicone case for wii fit balance board (green),0,0,0,1,1,2,4.5
puzzle quest - pc,0,0,2,0,0,2,3.0
persona 4 golden: solid gold premium edition - playstation vita,0,0,0,0,2,2,5.0
fifa soccer 2004,1,0,1,0,0,2,2.0
nascar '14 - xbox 360,0,0,0,0,2,2,5.0
playstation 3 darklite dvd remote,0,0,0,2,0,2,4.0
awakening: moonfell wood,0,0,0,0,2,2,5.0
new nintendo 3ds cover plates no.061 fire emblem fates,0,0,0,0,2,2,5.0
littlest pet shop: winter - nintendo ds,0,0,0,0,2,2,5.0
nintendo ds lite screen protector by madness gameware,0,0,0,1,1,2,4.5
women's murder club - death in scarlet - pc,0,0,0,2,0,2,4.0
powera wired controller for xbox one - white,0,0,1,0,1,2,4.0
minecraft: favorites pack - xbox one,0,0,0,1,1,2,4.5
diablo ii + expansion set,0,0,0,0,2,2,5.0
alchemy mysteries: prague legends [download],0,0,1,0,1,2,4.0
monster jam : urban assault for nintendo wii,0,0,0,1,1,2,4.5
tomee ac adapter for wii u console,0,0,0,0,2,2,5.0
ps4 accessory microusb 2.0 charge cable for sony playstation 4 dualshock 4 controller with cable tie [video game],0,0,0,0,2,2,5.0
duracell rechargeable gaming power for ps3 move controller,0,0,0,0,2,2,5.0
cabela's dangerous hunts 2009,0,0,0,1,1,2,4.5
playstation vita wi-fi light blue/white pch-2000za14(japan import),0,0,0,0,2,2,5.0
poptropica adventures - nintendo ds,0,0,1,0,1,2,4.0
"dreamgear ps4 prime-amplified, wired stereo headset with boom microphone and inline dual volume/mute controls",0,0,1,1,0,2,3.5
for honor: deluxe edition (includes extra content) - playstation 4,1,1,0,0,0,2,1.5
tomee spectrum stylus pen set for dsi/ ds lite (8-pack),0,0,0,1,1,2,4.5
hunting unlimited 5,0,0,0,0,2,2,5.0
"honwally universal kinect tv mount, kinect bracket set for xbox onexbox one s + camera lens cover",0,0,0,0,2,2,5.0
pitfall: the big adventure,0,0,0,0,2,2,5.0
dark tales 3:edgar allen poe's the premature burial - pc,0,0,0,0,2,2,5.0
"n64 retro bit controller ""solid black""",0,0,0,2,0,2,4.0
diablo,0,0,0,0,2,2,5.0
"the elder scrolls iv: oblivion, 5th anniversary edition",0,0,1,0,1,2,4.0
euro truck simulator 2 - pc,0,0,0,0,2,2,5.0
battlefield 3 - back to karkand dlc pack [online game code],0,0,0,1,1,2,4.5
beastron new wired infrared sensor bar for nintendo wii controller,0,0,0,0,2,2,5.0
"insten headset headphone with mic compatible with xbox 360 wireless controller, black",1,1,0,0,0,2,1.5
jewel quest 4/jewel quest mysteries 2 - pc,0,0,0,2,0,2,4.0
anno 2070 [download],1,0,1,0,0,2,2.0
tv mounting clip for kinect sensor,0,0,0,0,2,2,5.0
farming simulator 15 - xbox 360,0,0,0,0,2,2,5.0
dark dimensions 3: city of ash with bonus - pc,0,0,0,2,0,2,4.0
dragonball z: budokai 2 - gamecube,0,0,0,0,2,2,5.0
dreamworks shrek the third (platinum family hits),0,1,1,0,0,2,2.5
white haven mysteries [download],0,0,1,1,0,2,3.5
grand theft auto v: great white shark cash card - xbox one [digital code],0,0,2,0,0,2,3.0
active life: explorer with mat - nintendo wii,0,0,0,0,2,2,5.0
"nyko charge block solo - controller charging station with rechargeable battery, cover and included micro-usb/ac power cord for xbox one",0,0,0,1,1,2,4.5
fifa 15 [online game code],1,0,0,0,1,2,3.0
rock band bass drum pedal plate - pedal metal billet- factory blemished - please read product description,2,0,0,0,0,2,1.0
"gaems m155 15.5"" hd led performance portable gaming monitor for ps4, xbox one, and other consoles (console not included)",0,0,0,2,0,2,4.0
antiquity - hidden object game [download],0,0,0,1,1,2,4.5
mount & blade: warband [download],0,0,0,2,0,2,4.0
virtual villagers 4: the tree of life [download],0,0,0,2,0,2,4.0
battlefield 4 premium edition [online game code],0,0,0,0,2,2,5.0
just dance 2016 (gold edition)  playstation 4,0,0,0,0,2,2,5.0
x-men legends ii rise of the apocalypse - xbox,1,0,0,0,1,2,3.0
lego marvel super heroes: universe in peril - nintendo ds,0,1,0,0,1,2,3.5
supremery playstation 4 dualshock 4 aluminium buttons hats thumbsticks spare parts accessories for ps4,0,0,0,0,2,2,5.0
all star baseball 2002,0,0,0,0,2,2,5.0
"nyko data bank - data bank 3.5"" hard drive enclosure upgrade dock for xbox one",0,0,0,0,2,2,5.0
encore 38800 mystery masters - supernatural stories amr,0,0,0,1,1,2,4.5
sherlock holmes and the hound of the baskervilles [download],0,0,1,1,0,2,3.5
guitar hero: warriors of rock guitar bundle (wii),0,0,0,0,2,2,5.0
avatar: the burning earth - xbox 360,0,0,0,0,2,2,5.0
powera wired mini controllers for xbox one,0,0,0,0,2,2,5.0
power stand charger for ps3,0,0,0,0,2,2,5.0
grand theft auto v: bull shark cash card - ps4 [digital code],0,0,0,0,2,2,5.0
deer drive - nintendo wii,0,0,0,0,2,2,5.0
cabela's dangerous hunts 2011 with top shot elite -xbox 360,0,0,1,0,1,2,4.0
zettaguard xbox 360 wireless receiver for windows pc-black - pc,0,0,0,1,1,2,4.5
rapala pro bass fishing 2010 - nintendo wii,0,0,0,1,1,2,4.5
singstar rocks! - playstation 2,0,0,0,0,2,2,5.0
playstation 4 studded controller skin by foamy lizard ® particlegrip premium protective anti-slip silicone grip case cover for ps4 controller (photon - green),0,0,0,2,0,2,4.0
vigilante 8,0,0,0,0,2,2,5.0
gti racing [download],0,0,0,1,1,2,4.5
7 wonders of the ancient world 2 - pc,0,0,0,0,2,2,5.0
"murder, she wrote 2: return to cabot cove [download]",1,0,0,0,1,2,3.0
"nintendo nes game system with super mario bros. 1, 2 & 3",2,0,0,0,0,2,1.0
full parts replacement housing shell pack for nintendo gameboy advance sp gba sp(black)(battery is not included),0,0,0,0,2,2,5.0
fishdom 3 [download],0,0,1,0,1,2,4.0
crayola treasure adventures - nintendo ds,0,0,0,2,0,2,4.0
five nights at freddy's 2 [download],0,0,0,1,1,2,4.5
nintendo dsi xl 20 in 1 starter kit - burgundy,0,0,1,0,1,2,4.0
sesame street: elmo's a-to-zoo adventure - nintendo wii,0,0,0,1,1,2,4.5
"astro gaming a38 wireless headset, gray",0,0,0,0,2,2,5.0
horipadfpsplusblue,0,0,1,1,0,2,3.5
rock band bass pedal reinforcement - pedal metal,0,0,0,0,2,2,5.0
nba 2k10 - sony psp,0,1,0,0,1,2,3.5
"extremerate® textured black back panels, comfortable non-slip side rails, 3d splashing handles, game improvement replacement parts for xbox one standard controller",0,1,0,0,1,2,3.5
star wars: battlefront - season pass - xbox one digital code,0,1,0,0,1,2,3.5
new nintendo 3ds ll metallic blue (japanese imported version - only plays japanese version games),0,0,0,1,1,2,4.5
karaoke revolution presents: american idol encore bundle - nintendo wii,0,0,2,0,0,2,3.0
nintendo 2ds-crimson red w/mario kart 7 - nintendo 2ds,0,0,0,0,2,2,5.0
dragon age: inquisition - game of the year edition - pc [digital code],0,0,0,1,1,2,4.5
family feud: 2010 edition,0,0,1,0,1,2,4.0
bensussen deutsch xbox one mini series wired controller neon edition cpfa115320-01,1,0,0,1,0,2,2.5
luxor mahjong - pc,0,0,0,0,2,2,5.0
style lab: jewelry design - nintendo ds,0,0,0,1,1,2,4.5
nintendo 3ds xl super smash bros limited edition console - blue,0,0,0,0,2,2,5.0
world of zoo - nintendo wii,0,0,1,0,1,2,4.0
guitar hero world tour replacement cymbal wire cable left and right,1,0,0,1,0,2,2.5
il2 sturmovik series complete edition,1,0,0,0,1,2,3.0
hannah montana: spotlight world tour - nintendo wii,0,0,0,1,1,2,4.5
dualshock 4 wireless controller for playstation 4 - crystal,0,0,0,1,1,2,4.5
astro gaming mixamp pro [2014 model],0,0,0,1,1,2,4.5
diner dash 2 [download],0,0,0,0,2,2,5.0
fallout 4 - season pass - pc [download code],0,0,0,1,1,2,4.5
"uspro® wired usb gamepad, controller for pc & xbox 360,black",0,0,0,0,2,2,5.0
disney infinity (2.0 edition): power disc pack,0,0,1,0,1,2,4.0
rise of nations + rise of nations: thrones & patriots - pc,0,0,0,0,2,2,5.0
disney infinity: toy box starter pack (2.0 edition) - xbox 360,0,0,0,0,2,2,5.0
the sims 3: design and hi-tech stuff,0,0,1,0,1,2,4.0
xbox live 1600 microsoft points for minecraft: xbox 360 edition - xbox 360 digital code,0,0,0,1,1,2,4.5
kontrolfreek cqcx - xbox one,0,0,0,0,2,2,5.0
kontrolfreek cqcx thumb grips for playstation 4 controller (ps4),0,0,0,0,2,2,5.0
x3 terran conflict gold - windows,1,0,0,0,1,2,3.0
cake mania 3 nds,0,0,1,0,1,2,4.0
ac power adaptor for nintendo wii console [nintendo wii],0,0,0,0,2,2,5.0
usb rechargeable battery pack for xbox 360 wireless controller charger with usb cable,0,0,0,0,2,2,5.0
xbox 360 250gb holiday value bundle (amazon exclusive bonus value),0,0,0,0,2,2,5.0
spyro: a hero's tail,0,0,0,2,0,2,4.0
glow in dark playstation 3 ps3 wireless game controller anti-slip silicone case skin protector cover (many colors available),0,0,0,1,1,2,4.5
astro gaming a40 pc headset kit (2014 model),0,0,0,1,1,2,4.5
kmd ps4 live chat headset - small,0,0,0,1,1,2,4.5
virtual families [download],1,0,1,0,0,2,2.0
gamecube 64mb memory card (16x),0,0,0,0,2,2,5.0
call of duty: modern warfare 2 throat communicator for xbox 360,1,0,1,0,0,2,2.0
pdp afterglow ag 9 wireless headset for playstation 4,0,0,0,0,2,2,5.0
escape whisper valley,0,0,1,0,1,2,4.0
wwii fighters - pc,0,0,0,2,0,2,4.0
company of heroes anthology,0,0,0,0,2,2,5.0
rift collector's edition [download],0,0,0,0,2,2,5.0
gtron super nintendo gtron snes pc usb controller adapter converter,0,0,0,0,2,2,5.0
microsoft xbox genuine kinect sensor xbox 360,0,0,0,0,2,2,5.0
"fosmon 4 pack two-tone silicone skin case for nintendo wii remote and nunchuk (nunchaku) - blue, green, orange, pink",0,0,0,1,1,2,4.5
zacro 10 in 1 silicone thumb stick grips cap cover pack of 2 light bar decal stickers for ps4 controllers,1,0,0,1,0,2,2.5
red faction armageddon [download],0,0,0,2,0,2,4.0
playstation 2 wireless force 2 controller - black,0,0,0,2,0,2,4.0
shogun: total war warlord edition - pc,0,0,0,1,1,2,4.5
bejeweled 2,0,0,0,1,1,2,4.5
nintendo selects: animal crossing: city folk,0,0,0,0,2,2,5.0
scratches: directors cut - pc,0,0,0,1,1,2,4.5
rocksmith guitar and bass,0,0,0,0,2,2,5.0
simcity complete edition  [online game code],0,0,0,2,0,2,4.0
lost in blue 2 - nintendo ds,0,0,0,0,2,2,5.0
nintendo wii intercooler,0,0,0,1,1,2,4.5
leisure suit larry: uncut & uncensored - pc,0,0,0,1,1,2,4.5
restaurant empire - pc,0,0,0,1,1,2,4.5
tom clancy's the division - xbox one digital code,1,0,0,0,1,2,3.0
q bert - nintendo nes,0,0,0,0,2,2,5.0
ion ied07 premium rock band drum kit for xbox 360,0,0,1,0,1,2,4.0
rock band microphone for wii/xbox 360/ps3,0,0,0,1,1,2,4.5
game of thrones - a telltale games series - xbox one,0,0,1,0,1,2,4.0
xbox live 1 month gold membership card,0,0,0,0,2,2,5.0
e-mods gaming® xbox 360 torx t8 security screw tool for xbox 360 controller - repair screwdriver,0,0,0,0,2,2,5.0
tiger woods pga tour 14 - xbox 360,0,0,0,1,1,2,4.5
lego star wars: the force awakens - playstation 3 standard edition,0,0,0,0,2,2,5.0
transformers rise of the dark spark - nintendo 3ds,0,0,0,0,2,2,5.0
lego star wars: the force awakens,0,0,0,0,2,2,5.0
plants vs. zombies [online game code],0,0,0,0,2,2,5.0
disney infinity girls 3-figure power pack (ps3/xbox 360/nintendo wii/3ds/wii u) (uk import),0,0,0,1,1,2,4.5
butterfox thumb grips 6 pack for ps4 controllers (playstation 4),0,0,0,2,0,2,4.0
panzer tactics - nintendo ds,0,0,0,2,0,2,4.0
xcom: enemy unknown - slingshot [online game code],1,0,1,0,0,2,2.0
fifa 16 - deluxe edition - playstation 4,0,0,0,0,2,2,5.0
tom clancy's the division gold edition - xbox one digital code,0,0,0,0,2,2,5.0
dance dance revolution wii,0,0,0,0,2,2,5.0
madden nfl 09 - nintendo ds,0,0,0,0,2,2,5.0
e-mods gaming® xbox one silver chrome controller housing shell - original top shell,0,0,0,0,2,2,5.0
sentey mouse group,0,0,0,2,0,2,4.0
bundle monster vinyl skin sticker for playstation ps3 s slim - blue skull,0,0,0,0,2,2,5.0
"universal microphone for wii, ps3, xbox 360, ps2, pc",0,0,0,0,2,2,5.0
hidden object collection: treasure trove vol. 2 - pc,0,0,0,0,2,2,5.0
coffee rush [download],0,0,0,1,1,2,4.5
wii ddr non-slip game pad,0,0,2,0,0,2,3.0
classic controller for nintendo wii,0,0,1,0,1,2,4.0
the sims 3 deluxe [download],0,0,0,0,2,2,5.0
"extremerate® textured red back panels, comfortable non-slip side rails, 3d splashing handles, game improvement replacement parts for xbox one standard controller",0,1,0,0,1,2,3.5
butterfox deluxe 12-in-1 accessory travel pack / case for the new 3ds xl console: pink (nintendo 3ds xl),0,0,0,1,1,2,4.5
pirates of the caribbean - xbox,1,0,1,0,0,2,2.0
"blimark ps4 vertical stand dual cooler fan charging station for playstation dualshock controllers,with dual usb hub charger ports - best cooling and charging system",0,0,0,1,1,2,4.5
supermarket mania 2 [download],1,0,1,0,0,2,2.0
"mylifeunit xbox one vertical stand, simplicity cooling xbox one stand",0,0,0,0,2,2,5.0
"blackzone controllers© - (ps4 pro newest revision) ps4 modded, cod wwii, rapid fire jump shot, drop shot, burst, quick scope, sniper burst, auto aim, auto run, modified for cod and many others.",0,1,0,0,1,2,3.5
plants vs. zombies garden warfare 2 (deluxe edition) - xbox one,1,0,0,1,0,2,2.5
insten replacement playstation ps3 av cable compatible for playstation ps3 / ps2 / ps1 / ps3 slim (6ft),0,0,0,1,1,2,4.5
remington super slam hunting alaska wii,0,0,0,2,0,2,4.0
batman: arkham asylum [collector's edition] - playstation 3,0,0,0,0,2,2,5.0
hde silicone controller skin for ps4 dualshock controllers colorful protective grip for sony playstation 4 wireless game controllers (black),0,1,0,0,1,2,3.5
custom xbox 360 controller 9mm metal abxy/guide buttons (metal silver),0,0,0,0,2,2,5.0
the sims 3 plus showtime - pc,0,0,1,0,1,2,4.0
ratatouille - nintendo wii,0,0,2,0,0,2,3.0
up - xbox 360,0,0,1,0,1,2,4.0
tropico 4 - pc,0,1,1,0,0,2,2.5
microsoft flight simulator x acceleration expansion - pc,0,0,0,0,2,2,5.0
heavy fire: afghanistan wii,0,0,0,2,0,2,4.0
e-mods gaming® metal thumbsticks grip replacement for xbox one controllers - dark grey,0,0,0,0,2,2,5.0
screen protectors 2-pack for 3ds,0,0,0,0,2,2,5.0
dance dance revolution supernova 2 bundle (includes dance mat) - playstation 2,0,0,0,0,2,2,5.0
playstation 2 guitar hero wireless guitar,0,0,0,0,2,2,5.0
fable: the lost chapters [online game code],0,1,0,0,1,2,3.5
3rd party classic retro n64 bit usb wired controller for pc and mac - grey,0,1,0,0,1,2,3.5
thrustmaster t500rs racing wheel - playstation 3,0,1,0,0,1,2,3.5
red faction collection [online game code],0,1,0,0,1,2,3.5
xbox one 1tb console - tom clancy's rainbow six siege bundle,0,0,1,1,0,2,3.5
total war: shogun 2 gold - pc,0,1,0,0,1,2,3.5
black sigil: blade of the exiled - nintendo ds,1,0,0,0,0,1,1.0
arcanum : of steamworks & magick obscura,0,0,0,0,1,1,5.0
super nintendo snes to pc usb fx smart controller - plugfx,0,0,1,0,0,1,3.0
farming simulator 17 - pc,0,0,0,0,1,1,5.0
just dance 2016 - playstation 3,0,0,0,0,1,1,5.0
guitar hero live 2-pack bundle - xbox one,0,0,1,0,0,1,3.0
the elder scrolls v: skyrim special edition - xbox one,0,0,0,0,1,1,5.0
igt slots cleopatra ii [download],0,0,1,0,0,1,3.0
europa universalis iv digital extreme edition [online game code],0,0,0,1,0,1,4.0
10 pcs nes case cover sleeve for nintendo nes game cartridge,0,0,0,1,0,1,4.0
hde 128mb (2048 blocks) white memory card for nintendo gamecube or wii consoles,0,0,0,0,1,1,5.0
power a fus1on tournament controller for ps3,0,0,0,0,1,1,5.0
imagine fashion life - nintendo 3ds,0,0,0,0,1,1,5.0
"skullcandy plyr2 surround sound wireless gaming headset, black/yellow (smplfy-207)",0,0,0,0,1,1,5.0
don king boxing - nintendo wii,0,0,1,0,0,1,3.0
hde wired infrared sensor bar for nintendo wii,0,0,0,1,0,1,4.0
"the sims 3 70's, 80's and 90's stuff [download]",0,0,1,0,0,1,3.0
sid meier's civilization iii: complete [online game code],0,0,0,0,1,1,5.0
xbox 360 wired racing wheel,0,0,0,0,1,1,5.0
nintendo wii sports / wii sports resort - 2 games on 1 disc bundle version,0,0,0,0,1,1,5.0
astro gaming a40 and mixamp pro ps4 - dark grey [2014 model],0,0,0,0,1,1,5.0
xbox headset communicator,0,0,0,0,1,1,5.0
rechargeable controller battery pack white (2 packs) [xbox 360],0,0,0,0,1,1,5.0
unlikely suspects - pc,0,1,0,0,0,1,2.0
warcraft 2 battle chest: tides of darkness / beyond the dark portal,0,0,0,0,1,1,5.0
arcade zone - nintendo wii,0,0,0,0,1,1,5.0
playstation vita wi-fi model neon orange (pch-2000za24) japanese ver. japan import,0,0,0,0,1,1,5.0
8bitdo zero mini pocket bluetooth gamepad controller for android windows mac blue white,0,0,0,1,0,1,4.0
brunhilda and the dark crystal [download],0,0,0,1,0,1,4.0
microsoft xbox one 1tb console - 5 games holiday bundle,0,0,0,0,1,1,5.0
wii resident evil blaster,0,0,0,0,1,1,5.0
mylifeunit hand grip handle stand for nintendo new 3ds xl ll,0,0,0,0,1,1,5.0
slots wms double pack - pc/mac,0,0,0,0,1,1,5.0
microsoft xbox one kinect sensor bar (certified refurbished) [xbox one],0,0,0,0,1,1,5.0
villagers and heroes [download],0,0,1,0,0,1,3.0
insten wii controller wrist straps x 4 compatible with wiimote control,0,0,0,0,1,1,5.0
luxor: pharaoh's challenge - nintendo ds,0,0,1,0,0,1,3.0
star wars galaxies: an empire divided collectors edition - pc,0,0,1,0,0,1,3.0
hidden mysteries: notre dame - pc,0,1,0,0,0,1,2.0
chimaera wireless gaming headset,0,0,0,0,1,1,5.0
burger shop - pc/mac,0,0,0,0,1,1,5.0
goat simulator [online game code],0,0,0,1,0,1,4.0
mystery masters: mystical realms collection - 20 pack amr,0,0,0,0,1,1,5.0
pikmin 2,0,0,1,0,0,1,3.0
7 wonders trilogy - pc,0,0,0,1,0,1,4.0
fiction fixers 2: the curse of oz - pc,0,0,0,1,0,1,4.0
dual triggers for playstation 3 ps3- black,0,0,0,1,0,1,4.0
dream chronicles [download],0,0,0,0,1,1,5.0
playstation/ps2/psx av to rca cable,0,0,0,0,1,1,5.0
fishdom h2o: hidden odyssey [download],0,0,0,0,1,1,5.0
100 % hidden objects 2 [download],0,0,0,1,0,1,4.0
chocolatier: decadence by design [download],0,0,0,1,0,1,4.0
rock band: country track pack - nintendo wii,0,0,0,1,0,1,4.0
anacapri: the dream,0,0,1,0,0,1,3.0
pokemon nintendo for new nintendo 3ds xl skin vinyl decal stickers,0,0,0,1,0,1,4.0
mirror's edge catalyst collector's edition - playstation 4,0,0,1,0,0,1,3.0
fosmon ac adapter power cord charger for nintendo ds lite battery,0,0,0,0,1,1,5.0
amazonia - pc,0,0,0,1,0,1,4.0
black battery cover door for xbox one/ones wireless controller,0,0,0,0,1,1,5.0
(4) wii fit balance board replacement foot leg extensions,0,0,0,0,1,1,5.0
bw® 5 pair/10 pcs replacement silicone analog controller joystick thumb stick grips cap cover for ps3 / ps4 / xbox 360 / xbox one / wii game controllers (blue),0,0,0,0,1,1,5.0
playstation wired stereo gaming chat bass dual ear headset headphone with microphone boom mic for sony playstation 4 ps4,0,0,0,0,1,1,5.0
"rii mario kart racing wheel 2 piece - nintendo wii, black",0,0,0,0,1,1,5.0
everlast 2lb dumbbells - nintendo wii,0,0,0,1,0,1,4.0
arma 2 - operation arrowhead - pc,0,0,1,0,0,1,3.0
dancing with the stars - nintendo wii,0,1,0,0,0,1,2.0
donop black pc wireless controller gaming usb receiver adapter for pc xbox 360,0,0,0,0,1,1,5.0
sminiker professional dual wii remote charger charging station with 2 rechargeable batteries & led light for wii remote control- (original wii controllers not included)white,0,0,0,0,1,1,5.0
fifa soccer 12 - playstation 2,0,0,0,0,1,1,5.0
"multi-color multi system styluses, 6 pack - nintendo 3ds (discontinued by manufacturer)",0,0,0,0,1,1,5.0
lego marvel super heroes [download],0,0,0,1,0,1,4.0
bejeweled twist - pc,0,0,0,0,1,1,5.0
mystery pi: new york fortune - pc,0,0,0,0,1,1,5.0
microsoft xbox 360 live 12 months gold card,0,0,0,0,1,1,5.0
ac power adapter charging cable for nintendo wii u gamepad,0,0,0,0,1,1,5.0
cake mania 2,0,0,0,1,0,1,4.0
kontrolfreek cqc signature edition performance thumbsticks for playstation 4 controller (ps4),0,0,0,0,1,1,5.0
madden nfl 07 - pc,0,0,0,1,0,1,4.0
kontrolfreek fps freek vortex performance thumbsticks for playstation 3 and xbox 360 controller,0,0,0,1,0,1,4.0
plants vs. zombies garden warfare [online game code],0,0,0,0,1,1,5.0
turtle beach - ear force dxl1 gaming headset - dolby surround sound - xbox 360,0,0,0,1,0,1,4.0
"insten crystal shell compatible with microsoft xbox 360 wireless controller , clear",0,0,0,0,1,1,5.0
cosmos ® 3.6 feet replacement usb data/charge/sync cable for ps playstation vita & cosmos brand lcd cleaning cloth,0,0,0,1,0,1,4.0
global game gear ggg0038 cartridge case 5 pack for nintendo nes retro video games system carts covers sleeves dust protector,0,0,0,0,1,1,5.0
luxor evolved [download],0,0,0,0,1,1,5.0
disney epic mickey 2: the power of two - nintendo wii,0,0,0,1,0,1,4.0
"everydaysource® compatible with nintendo 3ds retractable stylus , metal w/black cap",1,0,0,0,0,1,1.0
"everydaysource compatible with nintendo 3ds retractable stylus , metal[10pc-wht/bk/red/pk/blue]",0,0,0,0,1,1,5.0
smite - pc only [download],1,0,0,0,0,1,1.0
barbie horse adventures: riding camp - nintendo wii,0,0,0,0,1,1,5.0
magic school bus oceans - nintendo ds,0,0,0,0,1,1,5.0
barbie: island princess - nintendo wii,0,0,0,0,1,1,5.0
$10 playstation store gift card [digital code],0,0,0,0,1,1,5.0
kinect tv mount for xbox one by foamy lizard ® kinect 2.0 tv mounting clip stand for xbox one console sensor,0,0,0,0,1,1,5.0
lego star wars: the force awakens - xbox 360 standard edition,0,0,0,1,0,1,4.0
tomee silicone skin protective case for ps4 controller (pink),0,0,1,0,0,1,3.0
aceshot thumb grips (8pc) for xbox one (one s & x) by foamy lizard ® sweat free 100% silicone precision raised antislip rubber analog stick grips for xbox one controller (8 grips) black,0,0,1,0,0,1,3.0
"go, diego, go!: great dinosaur rescue - nintendo ds",0,0,1,0,0,1,3.0
nintendo 64 controller - red,0,0,0,0,1,1,5.0
ds ps2 black controller,0,0,0,0,1,1,5.0
playstation wired gaming headset for sony playstation 4 ps4 black ps4 wired gaming headset with boom,0,0,0,1,0,1,4.0
"world of tanks with $30.00 in pack value-items included! 1-week premium account, gold currency and tank",1,0,0,0,0,1,1.0
all-in-one solitaire (mac) [download],0,0,0,0,1,1,5.0
bejeweled - pc,0,0,0,0,1,1,5.0
thrustmaster t.flight hotas 4 flight stick for ps4 & pc,0,0,0,0,1,1,5.0
cabela's big game hunter 2012 with top shot elite - nintendo wii (with top shot elite),0,0,0,0,1,1,5.0
controller skin for xbox one by foamy lizard (tm) [cyber monday sale!] premium chameleonskin (individual) protective anti-slip silicone grip case cover for wireless xbox one (battle - blue),0,0,0,0,1,1,5.0
lalaloopsy - nintendo ds,0,0,0,0,1,1,5.0
bookworm - pc,0,0,0,0,1,1,5.0
guitar hero live - wii u,0,0,0,0,1,1,5.0
igt slots: little green men - pc/mac,0,0,0,0,1,1,5.0
lost lands: the four horsemen [download],0,0,0,0,1,1,5.0
super famicom game console (japanese import video game),0,0,0,0,1,1,5.0
